state_abbr,county_name,combined_fips,votes_dem_2016,votes_gop_2016,total_votes_2016,per_dem_2016,per_gop_2016,diff_2016,per_point_diff_2016,FIPS,total_votes_2012,votes_dem_2012,votes_gop_2012,county_fips,state_fips,per_dem_2012,per_gop_2012,diff_2012,per_point_diff_2012
AL,Autauga County,1001,5908,18110,24661,0.239568549531649,0.73435789302948,12202,-0.494789343497831,1001,23909,6354,17366,1,1,0.265757664477812,0.726337362499477,11012,-0.460579698021666
AL,Baldwin County,1003,18409,72780,94090,0.195653098097566,0.773514719948985,54371,-0.577861621851419,1003,84988,18329,65772,3,1,0.215665741045795,0.773897491410552,47443,-0.558231750364757
AL,Barbour County,1005,4848,5431,10390,0.46660250240616,0.522714148219442,583,-0.056111645813282,1005,11459,5873,5539,5,1,0.512522907758094,0.483375512697443,334,0.029147395060651
AL,Bibb County,1007,1874,6733,8748,0.214220393232739,0.769661636945588,4859,-0.555441243712849,1007,8391,2200,6131,7,1,0.262185675128113,0.730663806459302,3931,-0.468478131331188
AL,Blount County,1009,2150,22808,25384,0.084699023006618,0.898518751969745,20658,-0.813819728963126,1009,23980,2961,20741,9,1,0.12347789824854,0.864929107589658,17780,-0.741451209341118
AL,Bullock County,1011,3530,1139,4701,0.750904062965327,0.242288874707509,2391,0.508615188257817,1011,5318,4058,1250,11,1,0.763068822865739,0.235050770966529,2808,0.52801805189921
AL,Butler County,1013,3716,4891,8685,0.427864133563615,0.563154864709269,1175,-0.135290731145653,1013,9483,4367,5081,13,1,0.460508277971106,0.535800906886007,714,-0.0752926289149
AL,Calhoun County,1015,13197,32803,47376,0.278558763931104,0.692396994258696,19606,-0.413838230327592,1015,46240,15500,30272,15,1,0.335207612456747,0.654671280276817,14772,-0.319463667820069
AL,Chambers County,1017,5763,7803,13778,0.418275511685295,0.566337639715488,2040,-0.148062128030193,1017,14562,6853,7596,17,1,0.470608432907568,0.521631644004944,743,-0.051023211097377
AL,Cherokee County,1019,1524,8809,10503,0.145101399600114,0.838712748738456,7285,-0.693611349138341,1019,9761,2126,7494,19,1,0.217805552709763,0.767749206023973,5368,-0.54994365331421
AL,Chilton County,1021,2909,15068,18255,0.159353601752944,0.825417693782525,12159,-0.666064092029581,1021,17434,3391,13910,21,1,0.194504990248939,0.797866238384765,10519,-0.603361248135827
AL,Choctaw County,1023,3109,4102,7268,0.427765547605944,0.564391854705559,993,-0.136626307099615,1023,7965,3785,4150,23,1,0.475204017576899,0.521029504080352,365,-0.045825486503453
AL,Clarke County,1025,5712,7109,12936,0.441558441558442,0.549551638837353,1397,-0.107993197278912,1025,13827,6317,7463,25,1,0.456859767122297,0.539741086280466,1146,-0.082881319158169
AL,Clay County,1027,1234,5230,6572,0.18776628119294,0.795800365185636,3996,-0.608034083992696,1027,6640,1770,4802,27,1,0.266566265060241,0.723192771084337,3032,-0.456626506024096
AL,Cleburne County,1029,684,5738,6532,0.104715248009798,0.878444580526638,5054,-0.77372933251684,1029,6302,971,5269,29,1,0.154078070453824,0.836083782926055,4298,-0.682005712472231
AL,Coffee County,1031,4194,15825,20513,0.204455711012529,0.771461999707503,11631,-0.567006288694974,1031,19715,4899,14638,31,1,0.248490996703018,0.742480344915039,9739,-0.493989348212021
AL,Colbert County,1033,7296,16718,24626,0.296272232599691,0.678875984731585,9422,-0.382603752131893,1033,23374,9160,13931,33,1,0.39188842303414,0.596004107127578,4771,-0.204115684093437
AL,Conecuh County,1035,3069,3413,6543,0.469050894085282,0.521626165367568,344,-0.052575271282286,1035,7013,3551,3434,35,1,0.506345358619706,0.489662056181377,117,0.016683302438329
AL,Coosa County,1037,1780,3376,5223,0.340800306337354,0.646371816963431,1596,-0.305571510626077,1037,5243,2188,3028,37,1,0.417318329200839,0.577531947358383,840,-0.160213618157543
AL,Covington County,1039,2379,13222,15818,0.150398280440005,0.835883171070932,10843,-0.685484890630927,1039,15415,3155,12148,39,1,0.204670775218943,0.78806357444048,8993,-0.583392799221537
AL,Crenshaw County,1041,1663,4511,6252,0.265994881637876,0.721529110684581,2848,-0.455534229046705,1041,6411,2048,4326,41,1,0.319450943690532,0.674777725783809,2278,-0.355326782093277
AL,Cullman County,1043,3730,32734,37278,0.100059016041633,0.878105048554107,29004,-0.778046032512474,1043,33178,4855,27930,43,1,0.146331906685153,0.841822894689252,23075,-0.695490988004099
AL,Dale County,1045,4408,13798,18617,0.236772842026105,0.741150561314927,9390,-0.504377719288822,1045,18551,5283,13105,45,1,0.284782491509892,0.706430920166029,7822,-0.421648428656137
AL,Dallas County,1047,12826,5784,18730,0.684783769353978,0.308809396689802,7042,0.375974372664175,1047,20936,14599,6284,47,1,0.697315628582346,0.300152846771112,8315,0.397162781811234
AL,DeKalb County,1049,3682,21779,26086,0.141148508778655,0.834892279383577,18097,-0.693743770604922,1049,23842,5235,18316,49,1,0.219570505830048,0.768224142269944,13081,-0.548653636439896
AL,Elmore County,1051,8436,27619,36905,0.228586912342501,0.748380978187238,19183,-0.519794065844736,1051,35440,8940,26223,51,1,0.252257336343115,0.739926636568849,17283,-0.487669300225734
AL,Escambia County,1053,4698,10282,15213,0.308814829422205,0.675869322290147,5584,-0.367054492867942,1053,14832,5476,9263,53,1,0.369201725997842,0.624528047464941,3787,-0.255326321467098
AL,Etowah County,1055,10350,32132,43474,0.238073331186456,0.739108432626397,21782,-0.501035101439941,1055,42490,12792,29102,55,1,0.301059072722994,0.684914097434691,16310,-0.383855024711697
AL,Fayette County,1057,1358,6705,8196,0.165690580771108,0.818081991215227,5347,-0.652391410444119,1057,7912,1803,6034,57,1,0.227881698685541,0.762639029322548,4231,-0.534757330637007
AL,Franklin County,1059,2197,9466,11955,0.183772480133835,0.791802593057298,7269,-0.608030112923463,1059,10859,3171,7567,59,1,0.292015839395893,0.696841329772539,4396,-0.404825490376646
AL,Geneva County,1061,1522,9967,11659,0.130542928209967,0.854876061411785,8445,-0.724333133201818,1061,11318,2039,9173,61,1,0.180155504506096,0.810478883194911,7134,-0.630323378688814
AL,Greene County,1063,4006,838,4862,0.823940765117236,0.172357054709996,3168,0.65158371040724,1063,5328,4514,799,63,1,0.847222222222222,0.149962462462463,3715,0.69725975975976
AL,Hale County,1065,4772,3172,8010,0.595755305867665,0.396004993757803,1600,0.199750312109863,1065,8628,5401,3205,65,1,0.625985164580436,0.371464997681966,2196,0.25452016689847
AL,Henry County,1067,2286,5623,8017,0.285144068853686,0.701384557814644,3337,-0.416240488960958,1067,8700,3046,5605,67,1,0.350114942528736,0.644252873563218,2559,-0.294137931034483
AL,Houston County,1069,10547,30567,42030,0.250939804901261,0.727266238401142,20020,-0.476326433499881,1069,41843,12348,29214,69,1,0.295103123581005,0.698181296752145,16866,-0.40307817317114
AL,Jackson County,1071,3663,16643,20785,0.176232860235747,0.80072167428434,12980,-0.624488814048593,1071,20555,5817,14422,71,1,0.282996837752372,0.70162977377767,8605,-0.418632936025298
AL,Jefferson County,1073,151581,130614,290111,0.522493114704372,0.45022077756445,20967,0.072272337139922,1073,303424,159658,141413,73,1,0.526187776840329,0.466057398228222,18245,0.060130378612107
AL,Lamar County,1075,1035,5819,6931,0.149329101139807,0.839561390852691,4784,-0.690232289712884,1075,7159,1643,5453,75,1,0.229501327000978,0.761698561251571,3810,-0.532197234250594
AL,Lauderdale County,1077,9877,27735,38813,0.254476592894133,0.71458016643908,17858,-0.460103573544946,1077,36908,12504,23902,77,1,0.338788338571583,0.647610274195296,11398,-0.308821935623713
AL,Lawrence County,1079,3611,10732,14623,0.246939752444779,0.733912329891267,7121,-0.486972577446488,1079,14079,5055,8855,79,1,0.359045386746218,0.628950919809646,3800,-0.269905533063428
AL,Lee County,1081,20987,34321,57668,0.363928001664701,0.595148089061525,13334,-0.231220087396823,1081,54115,21274,32062,81,1,0.393125750716068,0.592478979950106,10788,-0.199353229234039
AL,Limestone County,1083,9340,28824,39400,0.237055837563452,0.731573604060914,19484,-0.494517766497462,1083,35406,9809,25263,83,1,0.277043438965147,0.713523131672598,15454,-0.436479692707451
AL,Lowndes County,1085,4882,1751,6676,0.731276213301378,0.262282804074296,3131,0.468993409227082,1085,7519,5747,1754,85,1,0.764330363080197,0.233275701556058,3993,0.531054661524139
AL,Macon County,1087,7237,1394,8748,0.827274805669867,0.159350708733425,5843,0.667924096936443,1087,10385,9045,1322,87,1,0.870967741935484,0.127298988926336,7723,0.743668753009148
AL,Madison County,1089,62435,89199,159473,0.391508280398563,0.559336063158027,26764,-0.167827782759464,1089,154632,61802,90679,89,1,0.399671478089917,0.586418076465415,28877,-0.186746598375498
AL,Marengo County,1091,5607,5224,10948,0.512148337595908,0.47716477895506,383,0.034983558640848,1091,11509,6154,5321,91,1,0.534711964549483,0.462333825701625,833,0.072378138847858
AL,Marion County,1093,1432,11273,12912,0.11090458488228,0.873063816604709,9841,-0.762159231722429,1093,12104,2249,9696,93,1,0.185806345009914,0.801057501652346,7447,-0.615251156642432
AL,Marshall County,1095,4913,29217,34965,0.140511940511941,0.835607035607035,24304,-0.695095095095095,1095,32455,6271,25785,95,1,0.193221383454013,0.794484671083038,19514,-0.601263287629025
AL,Mobile County,1097,68429,91087,163387,0.418815450433633,0.557492334151432,22658,-0.138676883717799,1097,174189,78417,94566,97,1,0.450183421456005,0.542893064430016,16149,-0.092709642974011
AL,Monroe County,1099,4310,5771,10185,0.423171330387825,0.566617574864998,1461,-0.143446244477172,1099,10680,4897,5730,99,1,0.458520599250936,0.536516853932584,833,-0.077996254681648
AL,Montgomery County,1101,58669,33928,94572,0.620363321067546,0.3587531193165,24741,0.261610201751047,1101,101781,62993,38283,101,1,0.618907261669663,0.376131105019601,24710,0.242776156650062
AL,Morgan County,1103,11216,37392,49991,0.224360384869276,0.747974635434378,26176,-0.523614250565102,1103,49198,13401,35309,103,1,0.272389121509004,0.717691776088459,21908,-0.445302654579455
AL,Perry County,1105,3823,1403,5255,0.727497621313035,0.266983824928639,2420,0.460513796384396,1105,6065,4536,1504,105,1,0.747897774113768,0.2479802143446,3032,0.499917559769167
AL,Pickens County,1107,3972,5454,9494,0.41836949652412,0.574468085106383,1482,-0.156098588582263,1107,9599,4448,5119,107,1,0.463381602250234,0.533284717158037,671,-0.069903114907803
AL,Pike County,1109,5039,7681,13025,0.386871401151631,0.589712092130518,2642,-0.202840690978887,1109,14057,6009,7939,109,1,0.427473856441631,0.564771999715444,1930,-0.137298143273814
AL,Randolph County,1111,2290,7697,10130,0.226061204343534,0.759822309970385,5407,-0.533761105626851,1111,10391,3076,7219,111,1,0.296025406601867,0.69473582908286,4143,-0.398710422480993
AL,Russell County,1113,9577,9210,19136,0.500470317725752,0.481291806020067,367,0.019178511705686,1113,18871,10495,8276,113,1,0.556144348471199,0.438556515288008,2219,0.117587833183191
AL,St. Clair County,1115,5550,31579,37937,0.146295173577246,0.832406357909165,26029,-0.686111184331919,1115,35105,5790,29001,115,1,0.164933770118217,0.826121635094716,23211,-0.661187864976499
AL,Shelby County,1117,22927,72846,99208,0.231100314490767,0.734275461656318,49919,-0.503175147165551,1117,92204,19944,71243,117,1,0.216302980347924,0.772667129408702,51299,-0.556364149060778
AL,Sumter County,1119,4739,1581,6391,0.741511500547645,0.247379126897199,3158,0.494132373650446,1119,7025,5420,1585,119,1,0.77153024911032,0.225622775800712,3835,0.545907473309609
AL,Talladega County,1121,12108,20596,33218,0.364501174062255,0.620025287494732,8488,-0.255524113432476,1121,33317,13878,19217,121,1,0.41654410661224,0.57679262838791,5339,-0.16024852177567
AL,Tallapoosa County,1123,5271,12967,18504,0.284857328145266,0.700767401642888,7696,-0.415910073497622,1123,18668,6252,12303,123,1,0.334904649667881,0.659042211270624,6051,-0.324137561602743
AL,Tuscaloosa County,1125,31746,47701,81708,0.388529886914378,0.583798404073041,15955,-0.195268517158663,1125,78495,32003,45703,125,1,0.407707497292821,0.582240907064144,13700,-0.174533409771323
AL,Walker County,1127,4486,24208,29243,0.153404233491776,0.827822042882057,19722,-0.674417809390282,1127,28497,6551,21633,127,1,0.229883847422536,0.759132540267397,15082,-0.529248692844861
AL,Washington County,1129,2366,6031,8492,0.278615167216203,0.710197833254828,3665,-0.431582666038625,1129,8761,2971,5749,129,1,0.339116539207853,0.656203629722634,2778,-0.317087090514781
AL,Wilcox County,1131,4329,1737,6095,0.71025430680886,0.284987694831829,2592,0.42526661197703,1131,6547,4867,1676,131,1,0.743393920879792,0.25599511226516,3191,0.487398808614633
AL,Winston County,1133,871,9225,10255,0.084934178449537,0.899561189663579,8354,-0.814627011214042,1133,9712,1286,8310,133,1,0.132413509060956,0.855642504118616,7024,-0.723228995057661
AK,Alaska,2013,93003,130413,246588,0.377159472480413,0.528870018005742,37410,-0.15171054552533,2013,,,,,,,,,
AZ,Apache County,4001,12196,5315,18659,0.653625596227022,0.284849134465941,6881,0.36877646176108,4001,25465,16833,8198,1,4,0.661024936186923,0.321932063616729,8635,0.339092872570194
AZ,Cochise County,4003,15291,25036,43147,0.354393121190349,0.580248916494774,9745,-0.225855795304424,4003,43776,16223,26742,3,4,0.370591191520468,0.610882675438597,10519,-0.240291483918129
AZ,Coconino County,4005,25308,16573,44929,0.563288744463487,0.368870885174386,8735,0.194417859289101,4005,46746,26316,19368,5,4,0.562957258375048,0.414324220254139,6948,0.148633038120909
AZ,Gila County,4007,6746,13672,21398,0.315263108701748,0.638938218525096,6926,-0.323675109823348,4007,18477,6650,11525,7,4,0.359906911295124,0.623748444011474,4875,-0.26384153271635
AZ,Graham County,4009,3301,8025,11939,0.276488818158975,0.672166848144736,4724,-0.395678029985761,4009,11854,3608,8076,9,4,0.304369832967775,0.681289016365784,4468,-0.376919183398009
AZ,Greenlee County,4011,1092,1892,3243,0.33672525439408,0.58341042244835,800,-0.246685168054271,4011,2972,1310,1590,11,4,0.440780619111709,0.534993270524899,280,-0.09421265141319
AZ,La Paz County,4012,1318,3381,4931,0.267288582437639,0.685662137497465,2063,-0.418373555059826,4012,4922,1619,3205,12,4,0.328931328728159,0.6511580658269,1586,-0.32222673709874
AZ,Maricopa County,4013,549040,590465,1201934,0.456797128627695,0.491262415407169,41425,-0.034465286779474,4013,1187008,512008,654835,13,4,0.431343343937025,0.551668564997035,142827,-0.12032522106001
AZ,Mohave County,4015,16485,54656,74189,0.222202752429605,0.736712989796331,38171,-0.514510237366726,4015,65949,18324,46442,15,4,0.277851066733385,0.704210829580433,28118,-0.426359762847049
AZ,Navajo County,4017,15362,18165,35409,0.43384450281002,0.513005168177582,2803,-0.079160665367562,4017,35775,16157,19155,17,4,0.451628232005591,0.535429769392034,2998,-0.083801537386443
AZ,Pima County,4019,195649,147019,360762,0.542321530538139,0.407523519661162,48630,0.134798010876977,4019,351817,183470,162927,19,4,0.521492707856641,0.463101555638301,20543,0.058391152218341
AZ,Pinal County,4021,35737,53857,93805,0.380971163584031,0.574137839134375,18120,-0.193166675550344,4021,102139,41428,58947,21,4,0.405604127708319,0.577125290045918,17519,-0.171521162337599
AZ,Santa Cruz County,4023,10684,3650,14926,0.715797936486668,0.244539729331368,7034,0.4712582071553,4023,13894,9486,4235,23,4,0.682740751403484,0.304807830718296,5251,0.377932920685188
AZ,Yavapai County,4025,29705,58862,92780,0.320165984048286,0.63442552274197,29157,-0.314259538693684,4025,96790,32624,62385,25,4,0.337059613596446,0.644539725178221,29761,-0.307480111581775
AZ,Yuma County,4027,18336,20586,40759,0.449863833754508,0.505066365710641,2250,-0.055202531956132,4027,33935,14025,19500,27,4,0.413290113452188,0.574627965227641,5475,-0.161337851775453
AR,Arkansas County,5001,1939,3825,6167,0.314415437003405,0.620236743959786,1886,-0.305821306956381,5001,6488,2454,3892,1,5,0.378236744759556,0.599876695437731,1438,-0.221639950678175
AR,Ashley County,5003,2408,5338,8027,0.299987542045596,0.665005606079482,2930,-0.365018064033886,5003,7915,2855,4866,3,5,0.360707517372078,0.614782059380922,2011,-0.254074542008844
AR,Baxter County,5005,4163,14655,19572,0.212701818924995,0.748773758430411,10492,-0.536071939505416,5005,19339,5172,13688,5,5,0.267438854128962,0.707792543564817,8516,-0.440353689435855
AR,Benton County,5007,27894,60751,94262,0.295919882879633,0.644490887101907,32857,-0.348571004222274,5007,77525,22144,53477,7,5,0.285636891325379,0.689803289261529,31333,-0.40416639793615
AR,Boone County,5009,2925,12225,15912,0.183823529411765,0.768288084464555,9300,-0.58446455505279,5009,15363,3762,11143,9,5,0.244874048037493,0.7253140662631,7381,-0.480440018225607
AR,Bradley County,5011,1317,2163,3617,0.364113906552391,0.598009400055294,846,-0.233895493502903,5011,3634,1447,2118,11,5,0.398183819482664,0.582828838745184,671,-0.184645019262521
AR,Calhoun County,5013,636,1554,2250,0.282666666666667,0.690666666666667,918,-0.408,5013,2174,660,1458,13,5,0.303587856485741,0.670653173873045,798,-0.367065317387305
AR,Carroll County,5015,3334,6773,10656,0.312875375375375,0.635604354354354,3439,-0.322728978978979,5015,10172,3691,6121,15,5,0.362858828155722,0.601749901690916,2430,-0.238891073535195
AR,Chicot County,5017,2350,1716,4149,0.566401542540371,0.413593637020969,634,0.152807905519402,5017,4361,2649,1670,17,5,0.607429488649392,0.382939692731025,979,0.224489795918367
AR,Clark County,5019,3606,4398,8365,0.431081888822475,0.525762104004782,792,-0.094680215182307,5019,8406,3808,4343,19,5,0.45300975493695,0.516654770402094,535,-0.063645015465144
AR,Clay County,5021,1999,3779,5978,0.334392773502844,0.632151221144195,1780,-0.297758447641352,5021,5110,1738,3225,21,5,0.340117416829746,0.631115459882583,1487,-0.290998043052838
AR,Cleburne County,5023,2101,9454,11968,0.175551470588235,0.789939839572192,7353,-0.614388368983957,5023,11643,2618,8691,23,5,0.224856136734519,0.746457098685906,6073,-0.521600961951387
AR,Cleveland County,5025,723,2460,3299,0.219157320400121,0.745680509245226,1737,-0.526523188845105,5025,3266,845,2313,25,5,0.258726270667483,0.708205756276791,1468,-0.449479485609308
AR,Columbia County,5027,3140,5456,8837,0.355324205046962,0.61740409641281,2316,-0.262079891365848,5027,9455,3557,5790,27,5,0.376203067160233,0.612374405076679,2233,-0.236171337916446
AR,Conway County,5029,2655,4844,7837,0.338777593466888,0.61809365828761,2189,-0.279316064820722,5029,7724,3003,4511,29,5,0.388788192646297,0.584023821853962,1508,-0.195235629207664
AR,Craighead County,5031,10474,22798,34968,0.299530999771219,0.651967513154884,12324,-0.352436513383665,5031,31207,10351,20044,31,5,0.331688403242862,0.642291793507867,9693,-0.310603390265005
AR,Crawford County,5033,4476,16655,22155,0.202031144211239,0.751749040848567,12179,-0.549717896637328,5033,20562,4872,15125,33,5,0.236941931718704,0.735580196478942,10253,-0.498638264760237
AR,Crittenden County,5035,8368,6953,15798,0.529687302190151,0.440119002405368,1415,0.089568299784783,5035,15513,9092,6192,35,5,0.586089086572552,0.399149100754206,2900,0.186939985818346
AR,Cross County,5037,1995,4577,6831,0.292050944224857,0.67003367003367,2582,-0.377982725808813,5037,6680,2279,4268,37,5,0.341167664670659,0.638922155688623,1989,-0.297754491017964
AR,Dallas County,5039,1165,1507,2741,0.425027362276541,0.549799343305363,342,-0.124771981028822,5039,3083,1337,1664,39,5,0.433668504703211,0.539734025300032,327,-0.106065520596821
AR,Desha County,5041,2227,1915,4226,0.526975863700899,0.453147184098438,312,0.073828679602461,5041,4240,2353,1807,41,5,0.554952830188679,0.426179245283019,546,0.12877358490566
AR,Drew County,5043,2364,3967,6552,0.360805860805861,0.60546398046398,1603,-0.24465811965812,5043,6626,2627,3883,43,5,0.396468457591307,0.586024750980984,1256,-0.189556293389677
AR,Faulkner County,5045,14525,29170,46364,0.313281856612889,0.629151928220171,14645,-0.315870071607282,5045,41322,13559,26653,45,5,0.328130293790233,0.645007502057016,13094,-0.316877208266783
AR,Franklin County,5047,1376,5034,6698,0.205434458047178,0.751567632128994,3658,-0.546133174081815,5047,6539,1725,4631,47,5,0.263801804557272,0.708212264872305,2906,-0.444410460315033
AR,Fulton County,5049,1067,3470,4744,0.224915682967959,0.731450252951096,2403,-0.506534569983137,5049,4522,1452,2949,49,5,0.32109685979655,0.652145068553737,1497,-0.331048208757187
AR,Garland County,5051,12283,26053,40337,0.304509507400154,0.645883432084687,13770,-0.341373924684533,5051,39241,13317,25031,51,5,0.339364440253816,0.637878749267348,11714,-0.298514309013532
AR,Grant County,5053,1407,5160,6855,0.205251641137856,0.7527352297593,3753,-0.547483588621444,5053,6478,1467,4829,53,5,0.226458783575177,0.745446125347329,3362,-0.518987341772152
AR,Greene County,5055,3056,10698,14422,0.211898488420469,0.741783386492858,7642,-0.529884898072389,5055,13754,3998,9066,55,5,0.29067907517813,0.659153700741602,5068,-0.368474625563472
AR,Hempstead County,5057,2371,4391,6984,0.339490263459336,0.628722794959908,2020,-0.289232531500573,5057,6919,2466,4284,57,5,0.35640988582165,0.619164619164619,1818,-0.262754733342969
AR,Hot Spring County,5059,3137,8153,11815,0.265509944985188,0.69005501481168,5016,-0.424545069826492,5059,11239,3824,7087,59,5,0.340243793931844,0.630572114956847,3263,-0.290328321025002
AR,Howard County,5061,1350,3155,4634,0.291324989210186,0.680837289598619,1805,-0.389512300388433,5061,4419,1460,2862,61,5,0.330391491287622,0.647657841140529,1402,-0.317266349852908
AR,Independence County,5063,2878,9925,13443,0.214089117012572,0.73830246224801,7047,-0.524213345235439,5063,12390,3279,8724,63,5,0.264648910411622,0.70411622276029,5445,-0.439467312348668
AR,Izard County,5065,1111,4042,5396,0.205893254262417,0.749073387694589,2931,-0.543180133432172,5065,5313,1563,3571,65,5,0.294184076792772,0.672124976472803,2008,-0.37794089968003
AR,Jackson County,5067,1583,3262,5093,0.310818770861967,0.640486942862753,1679,-0.329668172000785,5067,5338,2093,3065,67,5,0.392094417384788,0.574185088047958,972,-0.18209067066317
AR,Jefferson County,5069,15721,9231,25683,0.612116964529066,0.359420628431258,6490,0.252696336097808,5069,27364,17456,9515,69,5,0.637918432977635,0.347719631632802,7941,0.290198801344833
AR,Johnson County,5071,2421,6072,8997,0.269089696565522,0.674891630543515,3651,-0.405801933977993,5071,8064,2785,5045,71,5,0.345362103174603,0.62562003968254,2260,-0.280257936507936
AR,Lafayette County,5073,1028,1750,2835,0.362610229276896,0.617283950617284,722,-0.254673721340388,5073,2928,1173,1712,73,5,0.400614754098361,0.584699453551913,539,-0.184084699453552
AR,Lawrence County,5075,1263,4064,5629,0.224373778646296,0.721975484100195,2801,-0.497601705453899,5075,5537,1786,3535,75,5,0.322557341520679,0.638432364096081,1749,-0.315875022575402
AR,Lee County,5077,1735,1229,3004,0.577563249001332,0.409121171770972,506,0.16844207723036,5077,3424,2107,1280,77,5,0.61536214953271,0.373831775700935,827,0.241530373831776
AR,Lincoln County,5079,1252,2455,3814,0.328264289459885,0.643681174619822,1203,-0.315416885159937,5079,3725,1424,2199,79,5,0.382281879194631,0.590335570469799,775,-0.208053691275168
AR,Little River County,5081,1397,3604,5192,0.269067796610169,0.694144838212635,2207,-0.425077041602465,5081,5051,1552,3385,81,5,0.307265887942982,0.670164323896258,1833,-0.362898435953277
AR,Logan County,5083,1712,5737,7839,0.21839520346983,0.731853552749075,4025,-0.513458349279245,5083,7330,2009,5078,83,5,0.274079126875853,0.692769440654843,3069,-0.418690313778991
AR,Lonoke County,5085,5638,19902,26766,0.21064036464171,0.743555256668908,14264,-0.532914892027199,5085,24083,5612,17863,85,5,0.233027446746668,0.741726529086908,12251,-0.50869908234024
AR,Madison County,5087,1587,4917,6782,0.234001769389561,0.725007372456502,3330,-0.491005603066942,5087,6567,2099,4262,87,5,0.319628445256586,0.649002588701081,2163,-0.329374143444495
AR,Marion County,5089,1377,5077,6718,0.204971717773147,0.755730872283418,3700,-0.550759154510271,5089,7029,2024,4771,89,5,0.287949921752739,0.678759425238298,2747,-0.39080950348556
AR,Miller County,5091,4273,11293,16015,0.266812363409304,0.705151420543241,7020,-0.438339057133937,5091,15329,4518,10622,91,5,0.294735468719421,0.692934959879966,6104,-0.398199491160545
AR,Mississippi County,5093,5621,6988,12995,0.432550981146595,0.537745286648711,1367,-0.105194305502116,5093,13349,6445,6599,93,5,0.482807700951382,0.494344145628886,154,-0.011536444677504
AR,Monroe County,5095,1298,1400,2766,0.469269703543022,0.506146059291396,102,-0.036876355748373,5095,3230,1583,1585,95,5,0.490092879256966,0.490712074303406,2,-0.00061919504644
AR,Montgomery County,5097,735,2573,3445,0.213352685050798,0.746879535558781,1838,-0.533526850507983,5097,3403,920,2368,97,5,0.270349691448722,0.695856597120188,1448,-0.425506905671466
AR,Nevada County,5099,1156,2001,3233,0.357562635323229,0.618929786575936,845,-0.261367151252706,5099,3384,1314,1996,99,5,0.388297872340425,0.58983451536643,682,-0.201536643026005
AR,Newton County,5101,699,2875,3731,0.187349236129724,0.770570892522112,2176,-0.583221656392388,5101,3661,993,2508,101,5,0.271237366839661,0.685058727123737,1515,-0.413821360284075
AR,Ouachita County,5103,4320,5347,9881,0.437202712276085,0.541139560773201,1027,-0.103936848497116,5103,10303,4626,5516,103,5,0.448995438221877,0.535378045229545,890,-0.086382607007668
AR,Perry County,5105,1035,2979,4213,0.245668169950154,0.707097080465227,1944,-0.461428910515072,5105,3937,1187,2580,105,5,0.301498602997206,0.655321310642621,1393,-0.353822707645415
AR,Phillips County,5107,4292,2443,6894,0.622570351029881,0.354366115462721,1849,0.26820423556716,5107,7900,5179,2591,107,5,0.655569620253165,0.327974683544304,2588,0.327594936708861
AR,Pike County,5109,684,3150,3956,0.172901921132457,0.796258847320526,2466,-0.623356926188069,5109,3787,850,2847,109,5,0.224452072880908,0.751782413519937,1997,-0.527330340639028
AR,Poinsett County,5111,1878,3149,5283,0.355479840999432,0.596062843081582,1271,-0.24058300208215,5111,7550,2387,4967,111,5,0.316158940397351,0.657880794701987,2580,-0.341721854304636
AR,Polk County,5113,1210,6606,8121,0.148996429011206,0.8134466198744,5396,-0.664450190863194,5113,7721,1556,5950,113,5,0.201528299443077,0.770625566636446,4394,-0.569097267193369
AR,Pope County,5115,4818,15694,21545,0.223624970990949,0.72842886980738,10876,-0.504803898816431,5115,20390,5108,14733,115,5,0.250514958312898,0.722560078469838,9625,-0.47204512015694
AR,Prairie County,5117,812,2503,3404,0.238542890716804,0.735311398354877,1691,-0.496768507638073,5117,3134,877,2149,117,5,0.279834077855775,0.685705169112955,1272,-0.405871091257179
AR,Pulaski County,5119,89377,61182,157728,0.566652718604179,0.387895617772368,28195,0.178757100831812,5119,159055,87055,68856,119,5,0.547326396529502,0.432906856118953,18199,0.11441954041055
AR,Randolph County,5121,1425,4508,6313,0.225724695073658,0.7140820529067,3083,-0.488357357833043,5121,5948,2040,3699,121,5,0.342972427706792,0.621889710827169,1659,-0.278917283120377
AR,St. Francis County,5123,4031,3195,7412,0.5438478143551,0.431057744198597,836,0.112790070156503,5123,8021,4652,3287,123,5,0.579977558907867,0.409799276898142,1365,0.170178282009724
AR,Saline County,5125,13247,35852,51971,0.254892151392123,0.689846260414462,22605,-0.434954109022339,5125,47059,12868,32962,125,5,0.273443974585095,0.700439873350475,20094,-0.42699589876538
AR,Scott County,5127,507,2378,3017,0.168047729532648,0.788200198873053,1871,-0.620152469340404,5127,3637,895,2630,127,5,0.246081935661259,0.723123453395656,1735,-0.477041517734397
AR,Searcy County,5129,601,2955,3698,0.162520281233099,0.799080584099513,2354,-0.636560302866414,5129,3694,814,2699,129,5,0.220357336220899,0.730644288034651,1885,-0.510286951813752
AR,Sebastian County,5131,12184,28769,43557,0.279725417269325,0.660490851068715,16585,-0.380765433799389,5131,43340,13083,29158,131,5,0.301868943239502,0.672773419473927,16075,-0.370904476234426
AR,Sevier County,5133,1075,3281,4517,0.237989816249723,0.726367057781714,2206,-0.48837724153199,5133,4328,1042,3135,133,5,0.240757855822551,0.724353049907579,2093,-0.483595194085028
AR,Sharp County,5135,1472,5405,7190,0.204728789986092,0.751738525730181,3933,-0.547009735744089,5135,7282,2092,4920,135,5,0.287283713265586,0.675638560834935,2828,-0.388354847569349
AR,Stone County,5137,1189,4081,5527,0.215125746336168,0.738375248778723,2892,-0.523249502442555,5137,5351,1356,3773,137,5,0.253410577462157,0.705101850121473,2417,-0.451691272659316
AR,Union County,5139,5667,10201,16338,0.346860080793243,0.624372628228669,4534,-0.277512547435427,5139,17160,6182,10696,139,5,0.36025641025641,0.623310023310023,4514,-0.263053613053613
AR,Van Buren County,5141,1547,5382,7111,0.217550274223035,0.756855575868373,3835,-0.539305301645338,5141,6421,1826,4362,141,5,0.284379380158854,0.679333437159321,2536,-0.394954057000467
AR,Washington County,5143,32296,40418,78153,0.413240694535079,0.51716504804678,8122,-0.103924353511701,5143,70231,28136,39570,143,5,0.40062080847489,0.563426407142145,11434,-0.162805598667255
AR,White County,5145,5157,21038,27451,0.187862008669994,0.76638373829733,15881,-0.578521729627336,5145,26508,5765,20005,145,5,0.217481515014335,0.754677833106987,14240,-0.537196318092651
AR,Woodruff County,5147,1117,1344,2550,0.438039215686274,0.527058823529412,227,-0.089019607843137,5147,2685,1340,1227,147,5,0.499068901303538,0.456983240223464,113,0.042085661080075
AR,Yell County,5149,1472,4600,6389,0.230395993113163,0.719987478478635,3128,-0.489591485365472,5149,5971,1720,4041,149,5,0.288058951599397,0.676771060123932,2321,-0.388712108524535
CA,Alameda County,6001,486351,91189,613195,0.793142475069105,0.148711258245746,395162,0.64443121682336,6001,558386,438091,104330,1,6,0.784566590136572,0.186842076986171,333761,0.597724513150401
CA,Alpine County,6003,318,211,575,0.55304347826087,0.36695652173913,107,0.186086956521739,6003,647,389,236,3,6,0.601236476043277,0.364760432766615,153,0.236476043276662
CA,Amador County,6005,5904,10239,17186,0.343535435819853,0.595775631327825,4335,-0.252240195507972,6005,15303,6001,8903,5,6,0.392145330980853,0.581781350062079,2902,-0.189636019081226
CA,Butte County,6007,38676,42193,87847,0.440265461541088,0.480300977836466,3517,-0.040035516295377,6007,70163,32567,35312,7,6,0.464162022718527,0.503285207302994,2745,-0.039123184584468
CA,Calaveras County,6009,7738,13072,22334,0.346467269633742,0.585295961314588,5334,-0.238828691680845,6009,18469,7404,10537,9,6,0.400887974443662,0.570523580053062,3133,-0.1696356056094
CA,Colusa County,6011,2659,3551,6594,0.403245374582954,0.538519866545344,892,-0.13527449196239,6011,5865,2248,3521,11,6,0.383290707587383,0.600341005967604,1273,-0.217050298380222
CA,Contra Costa County,6013,286658,105819,415972,0.689128114392315,0.254389718538748,180839,0.434738395853567,6013,351257,230826,112547,13,6,0.657142775802333,0.320412119900813,118279,0.336730655901519
CA,Del Norte County,6015,3485,5134,9361,0.372289285332764,0.548445678880461,1649,-0.176156393547698,6015,7940,3396,4256,15,6,0.427707808564232,0.536020151133501,860,-0.108312342569269
CA,El Dorado County,6017,35243,47633,89228,0.394976913076613,0.533834670731161,12390,-0.138857757654548,6017,85923,34033,49661,17,6,0.396087194348428,0.577970974011615,15628,-0.181883779663187
CA,Fresno County,6019,123660,113949,250264,0.494118211169006,0.455315187162356,9711,0.038803024006649,6019,180244,85862,91143,19,6,0.476365371385455,0.50566454361865,5281,-0.029299172233195
CA,Glenn County,6021,3065,5788,9379,0.326793901268792,0.617123360699435,2723,-0.290329459430643,6021,9142,3276,5608,21,6,0.358346094946401,0.613432509297747,2332,-0.255086414351345
CA,Humboldt County,6023,19596,10883,33636,0.582590082054941,0.323552146509692,8713,0.259037935545249,6023,46269,27757,15653,23,6,0.599904903931358,0.338304264194169,12104,0.261600639737189
CA,Imperial County,6025,28467,11295,41751,0.68182798016814,0.27053244233671,17172,0.411295537831429,6025,27453,17464,9545,25,6,0.63614176956981,0.347685134593669,7919,0.288456634976141
CA,Inyo County,6027,3155,4248,7996,0.394572286143072,0.531265632816408,1093,-0.136693346673337,6027,6501,2775,3541,27,6,0.426857406552838,0.544685433010306,766,-0.117828026457468
CA,Kern County,6029,86481,119164,217725,0.397202893558388,0.547314272591572,32683,-0.150111379033184,6029,168116,64690,99840,29,6,0.384793832829713,0.593875657284256,35150,-0.209081824454543
CA,Kings County,6031,12902,17446,32250,0.400062015503876,0.540961240310078,4544,-0.140899224806202,6031,30139,12282,17184,31,6,0.407511861707422,0.570158266697634,4902,-0.162646404990212
CA,Lake County,6033,6240,5752,13045,0.478344193177463,0.440935224223841,488,0.037408968953622,6033,16274,9159,6474,33,6,0.562799557576502,0.397812461595182,2685,0.16498709598132
CA,Lassen County,6035,2224,7574,10422,0.213394741892151,0.726731913260411,5350,-0.513337171368259,6035,10603,3044,7261,35,6,0.287088559841554,0.684806186928228,4217,-0.397717627086673
CA,Los Angeles County,6037,1893770,620285,2652072,0.71407186531889,0.233886938212839,1273485,0.480184927106051,6037,2427869,1672164,699600,37,6,0.688737324789764,0.288153932522718,972564,0.400583392267046
CA,Madera County,6039,13283,19221,34263,0.387677669789569,0.560984152000701,5938,-0.173306482211132,6039,32372,12698,18990,39,6,0.392252563944149,0.58661806499444,6292,-0.19436550105029
CA,Marin County,6041,86650,17531,109941,0.78815000773142,0.159458254882164,69119,0.628691752849256,6041,99286,73450,23347,41,6,0.73978204379268,0.235148963600105,50103,0.504633080192575
CA,Mariposa County,6043,3122,5185,8877,0.351695392587586,0.584093725357666,2063,-0.23239833277008,6043,7805,3080,4434,43,6,0.394618834080718,0.568097373478539,1354,-0.173478539397822
CA,Mendocino County,6045,6905,3571,11435,0.603847835592479,0.312286838653258,3334,0.291560996939222,6045,17928,11869,5129,45,6,0.662037037037037,0.286088799643016,6740,0.375948237394021
CA,Merced County,6047,21856,18486,42523,0.513980669284858,0.434729440538062,3370,0.079251228746796,6047,50538,26128,23403,47,6,0.516997111084728,0.463077288377063,2725,0.053919822707666
CA,Modoc County,6049,798,2413,3359,0.237570705567133,0.718368562072045,1615,-0.480797856504912,6049,3986,1113,2779,49,6,0.27922729553437,0.697190165579528,1666,-0.417962870045158
CA,Mono County,6051,2696,2080,5154,0.523088863019014,0.403570042685293,616,0.119518820333721,6051,4917,2574,2202,51,6,0.523489932885906,0.447834045149481,372,0.075655887736425
CA,Monterey County,6053,64733,26378,96676,0.669587074351442,0.272849517977575,38355,0.396737556373867,6053,78522,51712,25087,53,6,0.658567025801686,0.319490079213469,26625,0.339076946588217
CA,Napa County,6055,26161,11946,40393,0.647661723565964,0.29574431213329,14215,0.351917411432674,6055,32332,19964,11647,55,6,0.617468761598416,0.360231349746381,8317,0.257237411852035
CA,Nevada County,6057,16199,14686,33258,0.487070779962716,0.44157796620362,1513,0.045492813759096,6057,30864,14261,15696,57,6,0.462059357179886,0.50855365474339,1435,-0.046494297563504
CA,Orange County,6059,556544,472669,1092116,0.509601544158313,0.432801094389241,83875,0.076800449769072,6059,1021315,457077,541592,59,6,0.44753773321649,0.530288892261447,84515,-0.082751159044957
CA,Placer County,6061,61969,78977,150532,0.411666622379295,0.524652565567454,17008,-0.112985943188159,6061,126325,49126,74460,61,6,0.388885810409658,0.589432020581832,25334,-0.200546210172175
CA,Plumas County,6063,3224,5079,8830,0.365118912797282,0.57519818799547,1855,-0.210079275198188,6063,9128,3670,5240,63,6,0.402059596844873,0.574057843996494,1570,-0.171998247151621
CA,Riverside County,6065,339145,309514,683612,0.496107441063059,0.452762678244384,29631,0.043344762818675,6065,589721,287754,290227,65,6,0.487949386235186,0.492142894690879,2473,-0.004193508455693
CA,Sacramento County,6067,273768,163024,467526,0.585567433682833,0.348695045837023,110744,0.23687238784581,6067,388090,221063,157688,67,6,0.56961787214306,0.406318122085083,63375,0.163299750057976
CA,San Benito County,6069,10050,6471,17572,0.571932620077396,0.368256316867744,3579,0.203676303209652,6069,14972,8617,6052,69,6,0.575541009885119,0.404221212930804,2565,0.171319796954315
CA,San Bernardino County,6071,312517,253962,598783,0.521920294998355,0.424130277579691,58555,0.097790017418664,6071,531692,274203,245468,71,6,0.515717746364437,0.461673299579456,28735,0.054044446784981
CA,San Diego County,6073,567243,386807,1011651,0.560710165857593,0.382352214350601,180436,0.178357951506992,6073,928256,478386,431046,73,6,0.515359986900165,0.464361124517374,47340,0.050998862382791
CA,San Francisco County,6075,312443,34493,365295,0.85531693562737,0.094425053723703,277950,0.760891881903667,6075,321023,267857,42654,75,6,0.834385698221,0.132868984465288,225203,0.701516713755712
CA,San Joaquin County,6077,89791,68316,166647,0.538809579530385,0.409944373436066,21475,0.128865206094319,6077,149587,80005,66742,77,6,0.534839257422102,0.446175135539853,13263,0.088664121882249
CA,San Luis Obispo County,6079,63001,52672,124575,0.505727473409593,0.422813566124824,10329,0.082913907284768,6079,117597,57655,56500,79,6,0.490276112485863,0.480454433361395,1155,0.009821679124467
CA,San Mateo County,6081,219580,53731,287499,0.763759178292794,0.186891084838556,165849,0.576868093454238,6081,211814,151036,56244,81,6,0.713059571133164,0.265534856052952,94792,0.447524715080212
CA,Santa Barbara County,6083,100120,53740,164224,0.609655105222136,0.327235970381917,46380,0.282419134840218,6083,147249,84279,59096,83,6,0.572357027891531,0.40133379513613,25183,0.171023232755401
CA,Santa Clara County,6085,483472,137452,659148,0.733480189578061,0.208529799073956,346020,0.524950390504105,6085,491687,343239,136347,85,6,0.698084350409915,0.277304464018776,206892,0.420779886391139
CA,Santa Cruz County,6087,85185,20158,113509,0.750469125796192,0.17758944224687,65027,0.572879683549322,6087,81294,61106,17132,87,6,0.751666789676975,0.210741260117598,43974,0.540925529559377
CA,Shasta County,6089,20471,47587,72554,0.282148468726741,0.655883893375968,27116,-0.373735424649227,6089,54121,18184,34561,89,6,0.335987879011844,0.638587609245949,16377,-0.302599730234105
CA,Sierra County,6091,601,1048,1804,0.333148558758315,0.580931263858093,447,-0.247782705099778,6091,1779,652,1056,91,6,0.366498032602586,0.593591905564924,404,-0.227093872962338
CA,Siskiyou County,6093,7106,11212,19836,0.35823754789272,0.565234926396451,4106,-0.206997378503731,6093,17505,7110,9844,93,6,0.406169665809769,0.562353613253356,2734,-0.156183947443588
CA,Solano County,6095,97159,49595,156067,0.622546726726342,0.317780184151679,47564,0.304766542574663,6095,138565,87225,48364,95,6,0.629487965936564,0.349034749034749,38861,0.280453216901815
CA,Sonoma County,6097,116027,37421,164060,0.707222967207119,0.22809338047056,78606,0.47912958673656,6097,175738,124504,45666,97,6,0.708463735788503,0.2598527353219,78838,0.448611000466604
CA,Stanislaus County,6099,73939,72960,156141,0.473539941463165,0.467269967529349,979,0.006269973933816,6099,143620,70609,69549,99,6,0.491637654922713,0.484257067260827,1060,0.007380587661886
CA,Sutter County,6101,11831,16780,30429,0.388806730421637,0.551447632192974,4949,-0.162640901771337,6101,20988,8004,12576,101,6,0.381360777587193,0.599199542595769,4572,-0.217838765008576
CA,Tehama County,6103,6571,14981,22875,0.287256830601093,0.654907103825137,8410,-0.367650273224044,6103,17356,6032,10791,103,6,0.347545517400323,0.621744641622494,4759,-0.274199124222171
CA,Trinity County,6105,1876,2409,4716,0.397794741306192,0.510814249363868,533,-0.113019508057676,6105,5030,2367,2422,105,6,0.470576540755467,0.481510934393638,55,-0.010934393638171
CA,Tulare County,6107,39099,50488,94571,0.41343540831756,0.533863446511087,11389,-0.120428038193526,6107,72832,29191,42186,107,6,0.400799099297012,0.57922341827768,12995,-0.178424318980668
CA,Tuolumne County,6109,8580,13486,23472,0.365541922290389,0.574556918882072,4906,-0.209014996591684,6109,23730,9628,13410,109,6,0.405731142014328,0.565107458912769,3782,-0.159376316898441
CA,Ventura County,6111,170489,118764,307881,0.553749663019153,0.38574644099506,51725,0.168003222024094,6111,267907,138119,123919,111,6,0.515548305941987,0.462544838320761,14200,0.053003467621227
CA,Yolo County,6113,34460,13178,50623,0.680718250597554,0.260316456946447,21282,0.420401793651107,6113,59613,38856,19080,113,6,0.651804136681596,0.320064415479845,19776,0.331739721201751
CA,Yuba County,6115,7234,12313,21058,0.343527400512869,0.584718396808814,5079,-0.241190996295945,6115,15009,5817,8746,115,6,0.387567459524286,0.5827170364448,2929,-0.195149576920514
CO,Adams County,8001,86471,73807,175125,0.493767309064954,0.421453247680228,12664,0.072314061384725,8001,161495,90843,66531,1,8,0.562512771293229,0.411969410817672,24312,0.150543360475557
CO,Alamosa County,8003,3168,3031,6897,0.45933014354067,0.439466434681746,137,0.019863708858924,8003,6671,3782,2693,3,8,0.566931494528556,0.403687603058012,1089,0.163243891470544
CO,Arapahoe County,8005,148365,109638,281658,0.526755852842809,0.389259314487783,38727,0.137496538355026,8005,254746,135433,114232,5,8,0.531639358419759,0.448415284243913,21201,0.083224074175846
CO,Archuleta County,8007,2489,4234,7290,0.341426611796982,0.58079561042524,1745,-0.239368998628258,8007,6646,2637,3831,7,8,0.396780018055974,0.576436954559133,1194,-0.17965693650316
CO,Baca County,8009,278,1716,2107,0.131941148552444,0.814428096820123,1438,-0.682486948267679,8009,2096,462,1554,9,8,0.220419847328244,0.741412213740458,1092,-0.520992366412214
CO,Bent County,8011,581,1166,1892,0.30708245243129,0.616279069767442,585,-0.309196617336152,8011,1881,778,1053,11,8,0.413609782030835,0.559808612440191,275,-0.146198830409357
CO,Boulder County,8013,124715,38766,176735,0.705661017908168,0.219345347554248,85949,0.48631567035392,8013,173207,120485,48526,13,8,0.695612763918317,0.280161887221648,71959,0.415450876696669
CO,Broomfield County,8014,19530,14272,37342,0.523003588452681,0.382196989984468,5258,0.140806598468213,8014,32191,16653,14765,14,8,0.517318505172253,0.458668571961107,1888,0.058649933211146
CO,Chaffee County,8015,4773,5283,10999,0.433948540776434,0.480316392399309,510,-0.046367851622875,8015,10217,4967,4949,15,8,0.486150533424684,0.484388763824998,18,0.001761769599687
CO,Cheyenne County,8017,127,905,1076,0.118029739776952,0.841078066914498,778,-0.723048327137547,8017,1045,162,858,17,8,0.155023923444976,0.821052631578947,696,-0.666028708133971
CO,Clear Creek County,8019,2585,2426,5532,0.467281272595806,0.438539407086045,159,0.028741865509761,8019,5610,3041,2381,19,8,0.542067736185383,0.424420677361854,660,0.117647058823529
CO,Conejos County,8021,1753,1885,3970,0.441561712846348,0.474811083123426,132,-0.033249370277078,8021,4027,2180,1794,21,8,0.541345915073256,0.445492922771294,386,0.095852992301962
CO,Costilla County,8023,1109,581,1820,0.609340659340659,0.319230769230769,528,0.29010989010989,8023,1804,1317,440,23,8,0.730044345898004,0.24390243902439,877,0.486141906873614
CO,Crowley County,8025,336,1069,1511,0.222369291859696,0.70747849106552,733,-0.485109199205824,8025,1502,535,924,25,8,0.356191744340879,0.615179760319574,389,-0.258988015978695
CO,Custer County,8027,797,2059,3064,0.260117493472585,0.671997389033943,1262,-0.411879895561358,8027,2697,862,1776,27,8,0.319614386355209,0.658509454949944,914,-0.338895068594735
CO,Delta County,8029,4048,11584,16661,0.242962607286477,0.695276393973951,7536,-0.452313786687474,8029,15681,4542,10762,29,8,0.289649894777119,0.686308271156176,6220,-0.396658376379057
CO,Denver County,8031,174611,43637,232291,0.751690767184265,0.187854888910892,130974,0.563835878273373,8031,285564,209759,69755,31,8,0.734542869549383,0.244270986538919,140004,0.490271883010464
CO,Dolores County,8033,227,936,1230,0.184552845528455,0.760975609756098,709,-0.576422764227642,8033,1218,329,838,33,8,0.270114942528736,0.688013136288998,509,-0.417898193760263
CO,Douglas County,8035,67045,100178,182918,0.366530357865273,0.547666167353678,33133,-0.181135809488405,8035,150160,54093,93930,35,8,0.360235748534896,0.625532765050613,39837,-0.265297016515717
CO,Eagle County,8037,12652,8153,22611,0.55955066118261,0.360576710450666,4499,0.198973950731945,8037,22374,12598,9317,37,8,0.563064271028873,0.416420845624385,3281,0.146643425404487
CO,Elbert County,8039,3056,11536,15689,0.194786155905411,0.735292242972784,8480,-0.540506087067372,8039,13993,3542,10148,39,8,0.253126563281641,0.72521975273351,6606,-0.472093189451869
CO,El Paso County,8041,105807,176506,313273,0.337746949146591,0.563425510656839,70699,-0.225678561510248,8041,275604,104989,163819,41,8,0.380941495769292,0.594399936140259,58830,-0.213458440370967
CO,Fremont County,8043,5275,15066,21880,0.241087751371115,0.688574040219378,9791,-0.447486288848263,8043,20258,6644,13087,43,8,0.327969197354132,0.646016388587225,6443,-0.318047191233093
CO,Garfield County,8045,11205,13071,26328,0.425592525068368,0.496467639015497,1866,-0.070875113947129,8045,23695,10989,12159,45,8,0.463768727579658,0.51314623338257,1170,-0.049377505802912
CO,Gilpin County,8047,1634,1564,3574,0.457190822607722,0.437604924454393,70,0.01958589815333,8047,3271,1854,1320,47,8,0.566799143992663,0.403546316111281,534,0.163252827881382
CO,Grand County,8049,3319,4467,8513,0.389874309879009,0.5247268882885,1148,-0.134852578409491,8049,7961,3575,4149,49,8,0.449064187916091,0.521165682703178,574,-0.072101494787087
CO,Gunnison County,8051,5068,3250,9299,0.545004839230025,0.349499946230778,1818,0.195504892999247,8051,7912,4563,3106,51,8,0.576718907987867,0.392568250758342,1457,0.184150657229525
CO,Hinsdale County,8053,197,339,589,0.33446519524618,0.575551782682513,142,-0.241086587436333,8053,598,228,352,53,8,0.381270903010033,0.588628762541806,124,-0.207357859531773
CO,Huerfano County,8055,1631,1875,3772,0.432396606574761,0.497083775185578,244,-0.064687168610817,8055,3623,1897,1615,55,8,0.523599227159812,0.445763179685344,282,0.077836047474469
CO,Jackson County,8057,171,628,862,0.198375870069606,0.728538283062645,457,-0.530162412993039,8057,848,216,600,57,8,0.254716981132075,0.707547169811321,384,-0.452830188679245
CO,Jefferson County,8059,151885,130233,309529,0.490697156001538,0.420745713648802,21652,0.069951442352736,8059,300151,153069,139960,59,8,0.509973313432239,0.466298629689723,13109,0.043674683742516
CO,Kiowa County,8061,91,726,853,0.106682297772567,0.851113716295428,635,-0.74443141852286,8061,821,118,677,61,8,0.143727161997564,0.824604141291108,559,-0.680876979293544
CO,Kit Carson County,8063,526,2894,3613,0.145585386105729,0.800996401882092,2368,-0.655411015776363,8063,3525,789,2664,63,8,0.223829787234043,0.755744680851064,1875,-0.531914893617021
CO,Lake County,8065,1600,1264,3175,0.503937007874016,0.398110236220472,336,0.105826771653543,8065,2993,1807,1087,65,8,0.603742064817908,0.363180755095222,720,0.240561309722686
CO,La Plata County,8067,15300,12471,30722,0.498014452184103,0.405930603476336,2829,0.092083848707767,8067,28475,15063,12554,67,8,0.528990342405619,0.440877963125549,2509,0.08811237928007
CO,Larimer County,8069,92170,82624,193897,0.475355472235259,0.426123147856852,9546,0.049232324378407,8069,161823,83103,74603,69,8,0.513542574294136,0.461016048398559,8500,0.052526525895577
CO,Las Animas County,8071,2614,3656,6693,0.390557298670252,0.546242342746153,1042,-0.1556850440759,8071,6532,3282,3105,71,8,0.502449479485609,0.475352112676056,177,0.027097366809553
CO,Lincoln County,8073,399,1873,2402,0.166111573688593,0.779766860949209,1474,-0.613655287260616,8073,2248,537,1663,73,8,0.238879003558719,0.739768683274021,1126,-0.500889679715302
CO,Logan County,8075,1843,7272,9702,0.189960832817976,0.749536178107607,5429,-0.559575345289631,8075,9030,2675,6124,75,8,0.296234772978959,0.678183831672204,3449,-0.381949058693245
CO,Mesa County,8077,20958,48129,74876,0.279902772584006,0.642782734120412,27171,-0.362879961536407,8077,69033,22448,45087,77,8,0.325177813509481,0.653122419712312,22639,-0.327944606202831
CO,Mineral County,8079,237,344,652,0.363496932515337,0.52760736196319,107,-0.164110429447853,8079,650,291,344,79,8,0.447692307692308,0.529230769230769,53,-0.081538461538462
CO,Moffat County,8081,874,5293,6510,0.134254992319508,0.813056835637481,4419,-0.678801843317972,8081,6042,1291,4616,81,8,0.213670969877524,0.763985435286329,3325,-0.550314465408805
CO,Montezuma County,8083,3920,7771,12706,0.308515661892019,0.61160081851094,3851,-0.30308515661892,8083,12232,4486,7372,83,8,0.366742969260955,0.6026814911707,2886,-0.235938521909745
CO,Montrose County,8085,5438,14303,21070,0.258092074038918,0.678832463217845,8865,-0.420740389178927,8085,19054,5852,12789,85,8,0.30712711241734,0.671197648787656,6937,-0.364070536370316
CO,Morgan County,8087,3128,8104,11888,0.263122476446837,0.681695827725437,4976,-0.4185733512786,8087,10478,3761,6461,87,8,0.358942546287459,0.616625310173697,2700,-0.257682763886238
CO,Otero County,8089,1719,2988,5038,0.341206828106391,0.593092497022628,1269,-0.251885668916237,8089,8039,3566,4315,89,8,0.443587510884438,0.536758303271551,749,-0.093170792387113
CO,Ouray County,8091,1690,1337,3287,0.51414663827198,0.406753878916946,353,0.107392759355035,8091,3183,1640,1470,91,8,0.515237197612315,0.461828463713478,170,0.053408733898838
CO,Park County,8093,3351,6053,10245,0.327086383601757,0.590824792581747,2702,-0.26373840897999,8093,9054,3721,5085,93,8,0.410978573006406,0.561630218687873,1364,-0.150651645681467
CO,Phillips County,8095,436,1791,2332,0.18696397941681,0.768010291595197,1355,-0.581046312178388,8095,2265,588,1637,95,8,0.259602649006622,0.722737306843267,1049,-0.463134657836645
CO,Pitkin County,8097,7239,2522,10387,0.69692885337441,0.242803504380476,4717,0.454125348993935,8097,9779,6648,2941,97,8,0.679824112894979,0.300746497596891,3707,0.379077615298088
CO,Prowers County,8099,1173,3508,4978,0.235636801928485,0.704700683005223,2335,-0.469063881076738,8099,4809,1498,3200,99,8,0.311499272197962,0.66541900603036,1702,-0.353919733832398
CO,Pueblo County,8101,27945,27746,60112,0.464882219856268,0.461571732765504,199,0.003310487090764,8101,73306,40624,31023,101,8,0.554170190707446,0.423198646768341,9601,0.130971543939105
CO,Rio Blanco County,8103,433,2782,3436,0.126018626309662,0.809662398137369,2349,-0.683643771827707,8103,3311,561,2677,103,8,0.169435215946844,0.808517064331018,2116,-0.639081848384174
CO,Rio Grande County,8105,1985,3060,5488,0.361698250728863,0.557580174927114,1075,-0.195881924198251,8105,5453,2428,2892,105,8,0.445259490188887,0.530350265908674,464,-0.085090775719787
CO,Routt County,8107,7487,5149,13772,0.543639268080163,0.373874528027883,2338,0.16976474005228,8107,13038,7389,5361,107,8,0.566728025770824,0.411182696732628,2028,0.155545329038196
CO,Saguache County,8109,1345,1109,2707,0.496859992611747,0.409678611008497,236,0.087181381603251,8109,2796,1762,937,109,8,0.630185979971388,0.335121602288984,825,0.295064377682403
CO,San Juan County,8111,265,215,506,0.523715415019763,0.424901185770751,50,0.098814229249012,8111,506,266,212,111,8,0.525691699604743,0.41897233201581,54,0.106719367588933
CO,San Miguel County,8113,2960,1030,4311,0.686615634423568,0.238923683600093,1930,0.447691950823475,8113,4215,2961,1144,113,8,0.702491103202847,0.27141162514828,1817,0.431079478054567
CO,Sedgwick County,8115,267,1015,1364,0.19574780058651,0.744134897360704,748,-0.548387096774194,8115,1337,419,881,115,8,0.31338818249813,0.658937920718025,462,-0.345549738219895
CO,Summit County,8117,9502,5064,16061,0.591619450843659,0.315297926654629,4438,0.276321524189029,8117,15038,9169,5495,117,8,0.609722037504987,0.365407633993882,3674,0.244314403511105
CO,Teller County,8119,3547,9580,14203,0.249735971273675,0.674505386186017,6033,-0.424769414912343,8119,12144,3894,7909,119,8,0.320652173913043,0.651268115942029,4015,-0.330615942028985
CO,Washington County,8121,289,2284,2708,0.10672082717873,0.843426883308715,1995,-0.736706056129985,8121,2567,461,2059,121,8,0.179587066614725,0.802103622906116,1598,-0.622516556291391
CO,Weld County,8123,45869,75882,133790,0.342843261828238,0.567172434412138,30013,-0.2243291725839,8123,112695,47418,62350,123,8,0.420764009050978,0.553263232619016,14932,-0.132499223568038
CO,Yuma County,8125,701,3755,4664,0.150300171526587,0.805102915951973,3054,-0.654802744425386,8125,4481,950,3433,125,8,0.212006248605222,0.766123633117608,2483,-0.554117384512386
CT,Fairfield County,9001,238723,155457,410279,0.58185527409397,0.378905574011831,83266,0.202949700082139,9001,390611,214757,172238,1,9,0.549797624746871,0.440945083471792,42519,0.108852541275079
CT,Hartford County,9003,233789,147912,399219,0.585615915074182,0.370503407903932,85877,0.21511250717025,9003,392485,244314,143648,3,9,0.622479839993885,0.365996152719212,100666,0.256483687274673
CT,Litchfield County,9005,39836,53376,97434,0.408851119732332,0.547816983804421,13540,-0.13896586407209,9005,92404,43823,47207,5,9,0.474254361283061,0.510876152547509,3384,-0.036621791264447
CT,Middlesex County,9007,45306,38847,88402,0.512499717200968,0.43943575937196,6459,0.073063957829009,9007,83447,47851,34533,7,9,0.573429841695927,0.413831533787913,13318,0.159598307908013
CT,New Haven County,9009,203601,158373,375909,0.541623105592045,0.421306752432105,45228,0.12031635315994,9009,371783,230040,137942,9,9,0.618748033126851,0.371028261109303,92098,0.247719772017548
CT,New London County,9011,62951,54574,124527,0.50552089105174,0.43825033928385,8377,0.06727055176789,9011,114043,66510,45715,11,9,0.583201073279377,0.400857571266978,20795,0.182343502012399
CT,Tolland County,9013,38450,33989,77069,0.498903579908913,0.441020384330924,4461,0.057883195577989,9013,70780,39283,30391,13,9,0.555001412828483,0.429372704153716,8892,0.125628708674767
CT,Windham County,9015,21776,25738,50703,0.429481490247125,0.507622823107114,3962,-0.078141332859989,9015,46634,25953,19758,15,9,0.556525281983102,0.423682291890037,6195,0.132842990093065
DE,Kent County,10001,33347,36989,74253,0.449099699675434,0.498148222967422,3642,-0.049048523291988,10001,68669,35525,32134,1,10,0.517336789526569,0.46795497240385,3391,0.049381817122719
DE,New Castle County,10003,162905,85507,261468,0.623039913106001,0.3270266342344,77398,0.296013278871602,10003,251960,167051,81226,3,10,0.663006032703604,0.32237656770916,85825,0.340629464994443
DE,Sussex County,10005,39329,62607,105814,0.371680495964617,0.591670289375697,23278,-0.21998979341108,10005,93215,39971,52116,5,10,0.428804376977954,0.559094566325162,12145,-0.130290189347208
DC,District of Columbia,11001,260223,11553,280272,0.928465918821716,0.041220671347834,248670,0.887245247473882,11001,243348,222332,17337,1,11,0.913638082088203,0.071243651067607,204995,0.842394431020596
FL,Alachua County,12001,75370,46584,127827,0.589625040093251,0.364430049989439,28786,0.225194990103812,12001,120318,69634,48765,1,12,0.578749646769394,0.405300952475939,20869,0.173448694293456
FL,Baker County,12003,2112,10294,12634,0.167167959474434,0.814785499445939,8182,-0.647617539971505,12003,11366,2310,8974,3,12,0.203237726552877,0.789547774062995,6664,-0.586310047510118
FL,Bay County,12005,21689,62010,87151,0.248866909157669,0.711523677295728,40321,-0.462656768138059,12005,79834,22037,56863,5,12,0.276035273191873,0.712265450810432,34826,-0.436230177618559
FL,Bradford County,12007,2924,8913,12098,0.241692841792032,0.736733344354439,5989,-0.495040502562407,12007,11631,3324,8216,7,12,0.285787980397214,0.706388100765196,4892,-0.420600120367982
FL,Brevard County,12009,119525,181620,314337,0.380244769149034,0.577787533761536,62095,-0.197542764612502,12009,285504,122972,159270,9,12,0.430719009190764,0.557855581708137,36298,-0.127136572517373
FL,Broward County,12011,546956,258521,822837,0.664719744007622,0.314182517315094,288435,0.350537226692528,12011,755166,507430,243732,11,12,0.671944976336329,0.32275287817513,263698,0.349192098161199
FL,Calhoun County,12013,1236,4647,6067,0.203725070051096,0.765946925993077,3411,-0.562221855941981,12013,6152,1664,4366,13,12,0.270481144343303,0.709687906371912,2702,-0.439206762028609
FL,Charlotte County,12015,33421,60196,96323,0.34696801387,0.624939007298361,26775,-0.277970993428361,12015,84664,35896,47988,15,12,0.423981857696305,0.566805253708778,12092,-0.142823396012473
FL,Citrus County,12017,22765,54377,79590,0.286028395527076,0.683213971604473,31612,-0.397185576077397,12017,73923,28453,44657,17,12,0.384900504579089,0.604101565142107,16204,-0.219201060563018
FL,Clay County,12019,27768,74898,106363,0.261068228613334,0.70417344377274,47130,-0.443105215159407,12019,96549,25745,69996,19,12,0.266652166257548,0.724979026193953,44251,-0.458326859936405
FL,Collier County,12021,60941,105297,170505,0.357414738570716,0.617559602357702,44356,-0.260144863786986,12021,149080,51678,96508,21,12,0.346646096055809,0.647357123691978,44830,-0.300711027636168
FL,Columbia County,12023,7599,20359,28696,0.264810426540284,0.709471703373292,12760,-0.444661276833008,12023,27163,8462,18429,23,12,0.311526709126385,0.678459669403232,9967,-0.366932960276847
FL,DeSoto County,12027,3761,6744,10761,0.349502834309079,0.626707555059939,2983,-0.27720472075086,12027,9863,4174,5587,27,12,0.423197809996958,0.566460508972929,1413,-0.143262698975971
FL,Dixie County,12029,1270,5822,7202,0.176339905581783,0.808386559289086,4552,-0.632046653707303,12029,6941,1798,5052,29,12,0.259040484080104,0.727849013110503,3254,-0.468808529030399
FL,Duval County,12031,203627,210061,428734,0.474949502488723,0.489956476509911,6434,-0.015006974021188,12031,411702,196657,211553,31,12,0.477668313488883,0.513849823415966,14896,-0.036181509927083
FL,Escambia County,12033,57114,88370,151609,0.376719060214103,0.582880963531189,31256,-0.206161903317085,12033,148430,58154,88671,33,12,0.391794111702486,0.597392710368524,30517,-0.205598598666038
FL,Flagler County,12035,21985,33804,57413,0.382927211607127,0.588786511765628,11819,-0.205859300158501,12035,50589,23204,26966,35,12,0.458676787443911,0.533040779616122,3762,-0.074363992172211
FL,Franklin County,12037,1738,4119,6003,0.28952190571381,0.68615692153923,2381,-0.396635015825421,12037,5474,1845,3570,37,12,0.33704786262331,0.652173913043478,1725,-0.315126050420168
FL,Gadsden County,12039,14994,6721,22079,0.679106843607047,0.304406902486526,8273,0.374699941120522,12039,22495,15768,6628,39,12,0.700955767948433,0.294643254056457,9140,0.406312513891976
FL,Gilchrist County,12041,1457,6740,8418,0.173081492040865,0.800665241149917,5283,-0.627583749109052,12041,7908,1885,5917,41,12,0.238366211431462,0.748229640870005,4032,-0.509863429438543
FL,Glades County,12043,1271,2996,4355,0.291848450057405,0.687944890929966,1725,-0.39609644087256,12043,3989,1603,2344,43,12,0.401855101529205,0.587615943845575,741,-0.18576084231637
FL,Gulf County,12045,1715,5320,7279,0.235609286989971,0.730869624948482,3605,-0.495260337958511,12045,7107,2013,4995,45,12,0.283241874208527,0.70282819755171,2982,-0.419586323343183
FL,Hamilton County,12047,1899,3439,5451,0.348376444689048,0.630893414052467,1540,-0.28251696936342,12047,5404,2226,3137,47,12,0.411917098445596,0.580495928941525,911,-0.168578830495929
FL,Hardee County,12049,2147,5238,7577,0.283357529365184,0.691302626369275,3091,-0.407945097004091,12049,7222,2461,4694,49,12,0.340764331210191,0.649958460260316,2233,-0.309194129050125
FL,Hendry County,12051,4610,6192,11106,0.415090941833243,0.557536466774716,1582,-0.142445524941473,12051,10185,4751,5355,51,12,0.46647029945999,0.525773195876289,604,-0.059302896416299
FL,Hernando County,12053,31818,59029,93878,0.338929248599246,0.62878416668442,27211,-0.289854918085174,12053,83593,37791,44906,53,12,0.452083308410991,0.537198090749225,7115,-0.085114782338234
FL,Highlands County,12055,14901,29509,45589,0.326855162429533,0.64728333589243,14608,-0.320428173462897,12055,42440,16147,25912,55,12,0.380466540999058,0.610556079170594,9765,-0.230089538171536
FL,Hillsborough County,12057,306422,265928,595072,0.514932646805765,0.446883738438374,40494,0.068048908367391,12057,541503,286158,249904,57,12,0.52845136592041,0.461500674973177,36254,0.066950690947234
FL,Holmes County,12059,852,7476,8506,0.100164589701387,0.878909005407947,6624,-0.77874441570656,12059,8274,1264,6919,59,12,0.152767706067198,0.836233985980179,5655,-0.68346627991298
FL,Indian River County,12061,28997,48564,79897,0.362929772081555,0.607832584452483,19567,-0.244902812370928,12061,71445,27483,43441,61,12,0.384673525089229,0.608034152145007,15958,-0.223360627055777
FL,Jackson County,12063,6383,14231,20997,0.303995808925085,0.677763490022384,7848,-0.3737676810973,12063,20940,7342,13417,63,12,0.35062082139446,0.640735434574976,6075,-0.290114613180516
FL,Jefferson County,12065,3537,3930,7641,0.462897526501767,0.514330585001963,393,-0.051433058500196,12065,7808,3945,3808,65,12,0.505251024590164,0.487704918032787,137,0.017546106557377
FL,Lafayette County,12067,515,2795,3375,0.152592592592593,0.828148148148148,2280,-0.675555555555556,12067,3399,687,2668,67,12,0.202118270079435,0.784936746101795,1981,-0.582818476022359
FL,Lake County,12069,62597,101888,169898,0.368438710284994,0.599700997068829,39291,-0.231262286783835,12069,150796,61790,87637,69,12,0.409758879545876,0.581162630308496,25847,-0.17140375076262
FL,Lee County,12071,124725,191141,325797,0.382830412803064,0.586687415783448,66416,-0.203857002980383,12071,266034,110080,154112,71,12,0.413781697076314,0.579294375906839,44032,-0.165512678830525
FL,Leon County,12073,91936,53777,151925,0.60514069442159,0.353970709231529,38159,0.251169985190061,12073,148335,90863,55806,73,12,0.612552667947551,0.376215997573061,35057,0.23633667037449
FL,Levy County,12075,5091,13758,19367,0.262869830123406,0.710383642278102,8667,-0.447513812154696,12075,18396,6118,12052,75,12,0.332572298325723,0.65514242226571,5934,-0.322570123939987
FL,Liberty County,12077,651,2542,3295,0.197572078907436,0.771471927162367,1891,-0.573899848254932,12077,3284,942,2301,77,12,0.286845310596833,0.700669914738124,1359,-0.413824604141291
FL,Madison County,12079,3526,4849,8503,0.414677172762554,0.570269316711749,1323,-0.155592143949194,12079,8712,4174,4474,79,12,0.47910927456382,0.513544536271809,300,-0.034435261707989
FL,Manatee County,12081,71066,101681,178521,0.398082018361985,0.569574447824065,30615,-0.17149242946208,12081,153451,66476,85616,81,12,0.433206691386827,0.557937061342057,19140,-0.12473036995523
FL,Marion County,12083,61958,107710,174485,0.355090695475256,0.617302346906611,45752,-0.262211651431355,12083,161368,66823,93036,83,12,0.414103167914332,0.576545535670021,26213,-0.162442367755689
FL,Martin County,12085,30158,53182,85741,0.351733709660489,0.620263351255525,23024,-0.268529641595036,12085,78860,30097,48180,85,12,0.381651027136698,0.610956124778088,18083,-0.22930509764139
FL,Miami-Dade County,12086,623006,333666,978670,0.636584344058774,0.34093821206331,289340,0.295646131995463,12086,877245,540776,332602,86,12,0.616448084628581,0.379143796772851,208174,0.23730428785573
FL,Monroe County,12087,18949,21885,42434,0.446552292972616,0.515742093604185,2936,-0.069189800631569,12087,39045,19392,19234,87,12,0.496657702650788,0.492611089768216,158,0.004046612882571
FL,Nassau County,12089,10849,34221,46537,0.23312632958721,0.735350366375142,23372,-0.502224036787932,12089,40523,10249,29926,89,12,0.252918095896158,0.738494188485551,19677,-0.485576092589394
FL,Okaloosa County,12091,23711,71788,100657,0.235562355325511,0.713194313361217,48077,-0.477631958035706,12091,94739,23390,70143,91,12,0.246888820865747,0.74038146908876,46753,-0.493492648223013
FL,Okeechobee County,12093,3953,9342,13632,0.289979460093897,0.685299295774648,5389,-0.395319835680751,12093,12321,4856,7325,93,12,0.394123853583313,0.59451343235127,2469,-0.200389578767957
FL,Orange County,12095,329579,195091,545800,0.60384573103701,0.357440454378893,134488,0.246405276658116,12095,467385,274227,189057,95,12,0.586726146538721,0.40449950255143,85170,0.182226643987291
FL,Osceola County,12097,85287,50252,139981,0.609275544538187,0.358991577428365,35035,0.250283967109822,12097,108647,67201,40581,97,12,0.618526052260992,0.373512384143142,26620,0.24501366811785
FL,Palm Beach County,12099,371411,270762,657235,0.565111413725684,0.411971364884706,100649,0.153140048840978,12099,600341,349418,247257,99,12,0.582032544837018,0.411860925707223,102161,0.170171619129795
FL,Pasco County,12101,89998,141943,240814,0.373724119029625,0.589430016527278,51945,-0.215705897497654,12101,213358,98148,112335,101,12,0.460015560700794,0.526509434846596,14187,-0.066493874145802
FL,Pinellas County,12103,233327,238746,491520,0.474704996744792,0.48572998046875,5419,-0.011024983723958,12103,457484,238966,213192,103,12,0.522348322564286,0.466009740231352,25774,0.056338582332934
FL,Polk County,12105,117182,157216,283828,0.412862719675296,0.553912933184887,40034,-0.14105021350959,12105,248658,114610,131566,105,12,0.460914187357736,0.529104231514771,16956,-0.068190044157035
FL,Putnam County,12107,9920,21873,32652,0.303809873820899,0.669882396177876,11953,-0.366072522356977,12107,31323,11666,19326,107,12,0.372441975545127,0.616990709702136,7660,-0.244548734157009
FL,St. Johns County,12109,43037,88633,136392,0.315539034547481,0.649840166578685,45596,-0.334301132031204,12109,114733,35155,78490,109,12,0.30640704941037,0.684110064236096,43335,-0.377703014825726
FL,St. Lucie County,12111,66812,70248,140731,0.474749699781853,0.499165073793265,3436,-0.024415374011412,12111,123026,65869,56202,111,12,0.535407149708192,0.456830263521532,9667,0.07857688618666
FL,Santa Rosa County,12113,18398,65126,87432,0.21042638850764,0.744876017933937,46728,-0.534449629426297,12113,76816,17757,58169,113,12,0.231162778587794,0.757251093522183,40412,-0.526088314934389
FL,Sarasota County,12115,97676,124098,228509,0.427449247075608,0.543077077926909,26422,-0.115627830851301,12115,207434,95089,110489,115,12,0.458406047224659,0.532646528534377,15400,-0.074240481309718
FL,Seminole County,12117,105611,109265,224377,0.470685498067984,0.486970589677195,3654,-0.016285091609211,12117,208605,96435,109939,117,12,0.462285180125117,0.527019965964383,13504,-0.064734785839266
FL,Sumter County,12119,22631,52722,76649,0.29525499354199,0.687836762384376,30091,-0.392581768842385,12119,60471,19519,40644,119,12,0.322782821517752,0.672123827950588,21125,-0.349341006432836
FL,Suwannee County,12121,3955,14281,18675,0.211780455153949,0.76471218206158,10326,-0.55293172690763,12121,17627,4749,12672,121,12,0.269416236455438,0.718897146423101,7923,-0.449480909967663
FL,Taylor County,12123,2149,6923,9279,0.231598232568165,0.746093329022524,4774,-0.514495096454359,12123,9117,2761,6249,123,12,0.302840846769771,0.685422836459362,3488,-0.382581989689591
FL,Union County,12125,1014,4567,5693,0.178113472685754,0.802213244335148,3553,-0.624099771649394,12125,5393,1339,3980,125,12,0.248284813647321,0.737993695531244,2641,-0.489708881883924
FL,Volusia County,12127,108793,142763,260304,0.417945940131539,0.548447200196693,33970,-0.130501260065155,12127,234483,114716,117473,127,12,0.489229496381401,0.500987278395449,2757,-0.011757782014048
FL,Wakulla County,12129,4348,10507,15344,0.283368091762252,0.684762773722628,6159,-0.401394681960375,12129,14656,5173,9288,129,12,0.352961244541485,0.633733624454148,4115,-0.280772379912664
FL,Walton County,12131,6861,25695,33559,0.204445901248547,0.765666438213296,18834,-0.561220536964749,12131,28480,6665,21483,131,12,0.234023876404494,0.754318820224719,14818,-0.520294943820225
FL,Washington County,12133,2261,8630,11144,0.202889447236181,0.774407753050969,6369,-0.571518305814788,12133,10998,2820,8037,133,12,0.256410256410256,0.730769230769231,5217,-0.474358974358974
GA,Appling County,13001,1434,5492,7003,0.204769384549479,0.784235327716693,4058,-0.579465943167214,13001,7079,1756,5231,1,13,0.248057635259217,0.738946178838819,3475,-0.490888543579602
GA,Atkinson County,13003,696,1873,2604,0.267281105990783,0.719278033794163,1177,-0.451996927803379,13003,2902,930,1938,3,13,0.320468642315644,0.667815299793246,1008,-0.347346657477602
GA,Bacon County,13005,607,3356,4010,0.151371571072319,0.836907730673317,2749,-0.685536159600997,13005,3929,791,3092,5,13,0.201323491982693,0.786968694324256,2301,-0.585645202341563
GA,Baker County,13007,650,775,1440,0.451388888888889,0.538194444444444,125,-0.086805555555556,13007,1584,790,784,7,13,0.498737373737374,0.494949494949495,6,0.003787878787879
GA,Baldwin County,13009,7965,7691,16075,0.495489891135303,0.478444790046656,274,0.017045101088647,13009,16214,8469,7585,9,13,0.522326384605896,0.46780560009868,884,0.054520784507216
GA,Banks County,13011,684,6130,6946,0.098473941837029,0.88252231500144,5446,-0.784048373164411,13011,6191,779,5353,11,13,0.125827814569536,0.864642222581166,4574,-0.73881440801163
GA,Barrow County,13013,6580,21105,28828,0.228250312196476,0.732100735396143,14525,-0.503850423199667,13013,25171,6019,18719,13,13,0.239124389178022,0.743673274800366,12700,-0.504548885622343
GA,Bartow County,13015,8204,29879,39263,0.208949901943305,0.760996357894201,21675,-0.552046455950895,13015,35738,8383,26847,15,13,0.234568246684202,0.751217191784655,18464,-0.516648945100453
GA,Ben Hill County,13017,2098,3734,5923,0.354212392368732,0.630423771737295,1636,-0.276211379368563,13017,5947,2508,3395,17,13,0.421725239616613,0.57087607196906,887,-0.149150832352447
GA,Berrien County,13019,1041,5408,6563,0.158616486362944,0.824013408502209,4367,-0.665396922139266,13019,6187,1268,4837,19,13,0.204945854210441,0.781800549539357,3569,-0.576854695328916
GA,Bibb County,13021,34383,22589,58327,0.589486858573217,0.387282047765186,11794,0.202204810808031,13021,64625,38538,25606,21,13,0.596332688588008,0.396224371373308,12932,0.2001083172147
GA,Bleckley County,13023,1094,3717,4934,0.22172679367653,0.753344142683421,2623,-0.531617349006891,13023,4903,1266,3586,23,13,0.258209259636957,0.731388945543545,2320,-0.473179685906588
GA,Brantley County,13025,619,5561,6285,0.09848846459825,0.884805091487669,4942,-0.786316626889419,13025,6001,939,4963,25,13,0.156473921013165,0.827028828528579,4024,-0.670554907515414
GA,Brooks County,13027,2504,3679,6268,0.399489470325463,0.586949585194639,1175,-0.187460114869177,13027,6671,3101,3522,27,13,0.464847848898216,0.52795682806176,421,-0.063108979163544
GA,Bryan County,13029,4010,10513,15063,0.266215229369979,0.697935338246033,6503,-0.431720108876054,13029,13403,3695,9537,29,13,0.27568454823547,0.711557114078938,5842,-0.435872565843468
GA,Bulloch County,13031,8812,14476,24151,0.364871019833547,0.599395470166867,5664,-0.23452445033332,13031,24032,9572,14159,31,13,0.398302263648469,0.589172769640479,4587,-0.190870505992011
GA,Burke County,13033,4730,4491,9350,0.505882352941176,0.480320855614973,239,0.025561497326203,13033,9773,5403,4298,33,13,0.552849687915686,0.43978307582114,1105,0.113066612094546
GA,Butts County,13035,2566,6717,9477,0.270760789279308,0.708768597657487,4151,-0.438007808378179,13035,9372,2966,6306,35,13,0.316474605207,0.672855313700384,3340,-0.356380708493385
GA,Calhoun County,13037,1178,829,2023,0.58230350963915,0.40978744438952,349,0.172516065249629,13037,2187,1297,883,37,13,0.59304983996342,0.403749428440787,414,0.189300411522634
GA,Camden County,13039,5914,12287,18825,0.314156706507304,0.65269588313413,6373,-0.338539176626826,13039,17938,6358,11318,39,13,0.354443081725945,0.630951053629167,4960,-0.276507971903222
GA,Candler County,13043,1023,2661,3757,0.272291722118712,0.708277881288262,1638,-0.43598615916955,13043,3526,1155,2344,43,13,0.327566647759501,0.664775950085082,1189,-0.337209302325581
GA,Carroll County,13045,12422,29983,43744,0.283970373079737,0.685419714703731,17561,-0.401449341623994,13045,41445,12635,28249,45,13,0.304861865122451,0.681602123295934,15614,-0.376740258173483
GA,Catoosa County,13047,4769,20860,26510,0.179894379479442,0.786872878159185,16091,-0.606978498679743,13047,23639,5357,17848,47,13,0.226617031177292,0.755023478150514,12491,-0.528406446973222
GA,Charlton County,13049,1004,2950,4008,0.250499001996008,0.736027944111776,1946,-0.485528942115768,13049,3763,1197,2527,49,13,0.318097262822216,0.671538665958012,1330,-0.353441403135796
GA,Chatham County,13051,58998,43649,106013,0.556516653617953,0.411732523369775,15349,0.144784130248177,13051,108267,60077,47083,51,13,0.554896690589007,0.434878587196468,12994,0.120018103392539
GA,Chattahoochee County,13053,593,746,1384,0.428468208092486,0.539017341040462,153,-0.110549132947977,13053,1483,726,732,53,13,0.489548213081591,0.493594066082266,6,-0.004045853000674
GA,Chattooga County,13055,1612,6457,8246,0.195488721804511,0.783046325491147,4845,-0.587557603686636,13055,7791,2220,5434,55,13,0.284944166345784,0.697471441406751,3214,-0.412527275060968
GA,Cherokee County,13057,25203,80611,110825,0.227412587412587,0.727371982855854,55408,-0.499959395443266,13057,98041,19813,76473,57,13,0.20208892198162,0.780010403810651,56660,-0.577921481829031
GA,Clarke County,13059,29514,12691,44221,0.667420456344271,0.28699034395423,16823,0.380430112390041,13059,40138,25386,13804,59,13,0.632467985450197,0.343913498430415,11582,0.288554487019782
GA,Clay County,13061,697,566,1271,0.548387096774194,0.445318646734854,131,0.103068450039339,13061,1402,862,537,61,13,0.614835948644793,0.3830242510699,325,0.231811697574893
GA,Clayton County,13063,75908,11740,89236,0.850643238155005,0.131561253305841,64168,0.719081984849164,13063,96020,81439,14158,63,13,0.848146219537596,0.14744844823995,67281,0.700697771297646
GA,Clinch County,13065,685,1724,2443,0.280392959476054,0.705689725747032,1039,-0.425296766270978,13065,2472,852,1598,65,13,0.344660194174757,0.646440129449838,746,-0.301779935275081
GA,Cobb County,13067,159416,152602,326424,0.488370953116193,0.467496262529716,6814,0.020874690586477,13067,308989,132526,171464,67,13,0.428901999747564,0.554919430788798,38938,-0.126017431041235
GA,Coffee County,13069,4090,9575,13896,0.294329303396661,0.689047207829591,5485,-0.39471790443293,13069,14434,5048,9242,69,13,0.349729804627962,0.640293750866011,4194,-0.290563946238049
GA,Colquitt County,13071,3460,9892,13592,0.254561506768687,0.727781047675103,6432,-0.473219540906416,13071,13319,3971,9240,71,13,0.298145506419401,0.693745776709963,5269,-0.395600270290562
GA,Columbia County,13073,18863,43060,64190,0.293861972269824,0.670821000155788,24197,-0.376959027885963,13073,58842,16420,41724,73,13,0.279052377553448,0.709085347200979,25304,-0.430032969647531
GA,Cook County,13075,1752,4175,6038,0.290162305399139,0.69145412388208,2423,-0.401291818482941,13075,6027,2042,3934,75,13,0.338808694209391,0.652729384436702,1892,-0.31392069022731
GA,Coweta County,13077,16572,42513,61315,0.270276441327571,0.693353991682296,25941,-0.423077550354726,13077,55512,15156,39633,77,13,0.273022049286641,0.71395373973195,24477,-0.440931690445309
GA,Crawford County,13079,1419,3632,5157,0.275159976730657,0.70428543726973,2213,-0.429125460539073,13079,5123,1699,3366,79,13,0.331641616240484,0.657036892445833,1667,-0.325395276205348
GA,Crisp County,13081,2835,4539,7500,0.378,0.6052,1704,-0.2272,13081,7386,3160,4179,81,13,0.427836447332792,0.565800162469537,1019,-0.137963715136745
GA,Dade County,13083,965,5047,6238,0.154697018275088,0.809073420968259,4082,-0.654376402693171,13083,5997,1404,4458,83,13,0.234117058529265,0.743371685842921,3054,-0.509254627313657
GA,Dawson County,13085,1444,9880,11680,0.123630136986301,0.845890410958904,8436,-0.722260273972603,13085,10234,1241,8843,85,13,0.121262458471761,0.864080515927301,7602,-0.74281805745554
GA,Decatur County,13087,4104,6009,10238,0.400859542879469,0.586931041218988,1905,-0.186071498339519,13087,10465,4580,5816,87,13,0.437649307214525,0.555757286192069,1236,-0.118107978977544
GA,DeKalb County,13089,239131,47531,295871,0.808227234166241,0.160647714713507,191600,0.647579519452734,13089,305299,237704,64308,89,13,0.778594099554863,0.210639405959404,173396,0.567954693595459
GA,Dodge County,13091,1836,5021,6995,0.262473195139385,0.717798427448177,3185,-0.455325232308792,13091,7731,2440,5214,91,13,0.315612469279524,0.674427629025999,2774,-0.358815159746475
GA,Dooly County,13093,1860,1941,3836,0.484880083420229,0.50599582898853,81,-0.0211157455683,13093,4289,2278,1983,93,13,0.531126136628585,0.462345535089765,295,0.06878060153882
GA,Dougherty County,13095,23224,10227,33925,0.684568901989683,0.301459100957996,12997,0.383109801031688,13095,37822,26209,11441,95,13,0.692956480355349,0.302495901856063,14768,0.390460578499286
GA,Douglas County,13097,30971,24803,57365,0.539893663383596,0.432371655190447,6168,0.107522008193149,13097,55201,28410,26226,97,13,0.514664589409612,0.475100088766508,2184,0.039564500643104
GA,Early County,13099,2165,2552,4782,0.452739439565036,0.533667921371811,387,-0.080928481806776,13099,5349,2762,2556,99,13,0.51635819779398,0.477846326416153,206,0.038511871377828
GA,Echols County,13101,156,1006,1175,0.132765957446808,0.856170212765957,850,-0.723404255319149,13101,1102,173,917,101,13,0.156987295825771,0.832123411978221,744,-0.67513611615245
GA,Effingham County,13103,4851,17865,23395,0.207351998290233,0.763624706133789,13014,-0.556272707843556,13103,20779,4941,15591,103,13,0.23778815149911,0.750324847201502,10650,-0.512536695702392
GA,Elbert County,13105,2507,5269,7912,0.316860465116279,0.665950455005056,2762,-0.349089989888776,13105,8139,3179,4857,105,13,0.390588524388746,0.596756358274972,1678,-0.206167833886227
GA,Emanuel County,13107,2433,5330,7838,0.310410819086502,0.680020413370758,2897,-0.369609594284256,13107,8060,2919,5086,107,13,0.362158808933002,0.631017369727047,2167,-0.268858560794045
GA,Evans County,13109,1130,2404,3602,0.313714602998334,0.66740699611327,1274,-0.353692393114936,13109,3560,1266,2267,109,13,0.35561797752809,0.636797752808989,1001,-0.281179775280899
GA,Fannin County,13111,1920,9622,11764,0.163209792587555,0.817919075144509,7702,-0.654709282556953,13111,10007,2027,7853,111,13,0.202558209253523,0.784750674527831,5826,-0.582192465274308
GA,Fayette County,13113,23255,35034,60387,0.385099441932866,0.580157981022405,11779,-0.195058539089539,13113,58473,19703,38046,113,13,0.33695893831341,0.650659278641424,18343,-0.313700340328015
GA,Floyd County,13115,9127,24045,34250,0.266481751824818,0.702043795620438,14918,-0.43556204379562,13115,32685,9595,22636,115,13,0.293559736882362,0.692550099433991,13041,-0.398990362551629
GA,Forsyth County,13117,23427,69801,97314,0.240736173623528,0.717276034280782,46374,-0.476539860657254,13117,81598,14544,65853,117,13,0.178239662736832,0.807041839260766,51309,-0.628802176523934
GA,Franklin County,13119,1243,7054,8474,0.146683974510267,0.83242860514515,5811,-0.685744630634883,13119,7757,1499,6112,119,13,0.193244811138327,0.787933479437927,4613,-0.5946886682996
GA,Fulton County,13121,281875,110372,407173,0.69227330888836,0.271069054185813,171503,0.421204254702547,13121,386845,248479,133837,121,13,0.642321860176556,0.345970608383203,114642,0.296351251793354
GA,Gilmer County,13123,1955,10465,12713,0.153779595689452,0.823173129867065,8510,-0.669393534177613,13123,11008,1955,8920,123,13,0.177598110465116,0.81031976744186,6965,-0.632721656976744
GA,Glascock County,13125,138,1235,1390,0.099280575539568,0.888489208633093,1097,-0.789208633093525,13125,1333,176,1135,125,13,0.132033008252063,0.851462865716429,959,-0.719429857464366
GA,Glynn County,13127,11738,21482,34041,0.344819482388884,0.631062542228489,9744,-0.286243059839605,13127,33054,11922,20853,127,13,0.360682519513523,0.630876747141042,8931,-0.270194227627519
GA,Gordon County,13129,3176,15171,18850,0.168488063660477,0.804827586206896,11995,-0.636339522546419,13129,16857,3436,13174,129,13,0.203832235866406,0.781515097585573,9738,-0.577682861719167
GA,Grady County,13131,3005,6047,9187,0.327092630891477,0.658212691847175,3042,-0.331120060955698,13131,9391,3419,5922,131,13,0.36407198381429,0.630603769566606,2503,-0.266531785752316
GA,Greene County,13133,3194,5488,8831,0.361680443890839,0.621447174725399,2294,-0.25976673083456,13133,8313,3195,5067,133,13,0.384337784193432,0.609527246481415,1872,-0.225189462287983
GA,Gwinnett County,13135,165063,146463,323931,0.509562221584226,0.452142585921076,18600,0.057419635663151,13135,295560,131879,159563,135,13,0.446200433076194,0.539866693733929,27684,-0.093666260657735
GA,Habersham County,13137,2483,13184,16128,0.153955853174603,0.817460317460317,10701,-0.663504464285714,13137,14600,2297,12148,137,13,0.157328767123288,0.832054794520548,9851,-0.67472602739726
GA,Hall County,13139,16153,51681,70133,0.230319535739238,0.736899890208604,35528,-0.506580354469365,13139,59241,12489,45918,139,13,0.210816832936649,0.775105079252545,33429,-0.564288246315896
GA,Hancock County,13141,2695,841,3572,0.75447928331467,0.235442329227324,1854,0.519036954087346,13141,4076,3301,764,141,13,0.809862610402355,0.187438665358194,2537,0.622423945044161
GA,Haralson County,13143,1474,9579,11317,0.130246531766369,0.846425731200848,8105,-0.716179199434479,13143,10362,1787,8439,143,13,0.17245705462266,0.814418066010423,6652,-0.641961011387763
GA,Harris County,13145,4082,11931,16392,0.249023914104441,0.72785505124451,7849,-0.478831137140068,13145,15479,4141,11193,145,13,0.267523741843788,0.723108727954002,7052,-0.455584986110214
GA,Hart County,13147,2583,7285,10077,0.256326287585591,0.72293341272204,4702,-0.466607125136449,13147,9501,2869,6516,147,13,0.301968213872224,0.685822544995264,3647,-0.38385433112304
GA,Heard County,13149,743,3370,4206,0.176652401331431,0.801236329053733,2627,-0.624583927722302,13149,4162,947,3155,149,13,0.227534839019702,0.758049014896684,2208,-0.530514175876982
GA,Henry County,13151,49902,45641,98037,0.509011903669023,0.465548721401104,4261,0.043463182267919,13151,90469,43374,46299,151,13,0.479434944566647,0.51176646143983,2925,-0.032331516873183
GA,Houston County,13153,22460,35351,59559,0.377105055491194,0.593545895666482,12891,-0.216440840175288,13153,57912,22643,34631,153,13,0.39098977759359,0.597993507390524,11988,-0.207003729796933
GA,Irwin County,13155,890,2711,3659,0.243235856791473,0.740912817709757,1821,-0.497676960918284,13155,3683,1134,2519,155,13,0.307901167526473,0.683953298941081,1385,-0.376052131414608
GA,Jackson County,13157,4469,21754,27057,0.165169826662232,0.804006356950142,17285,-0.638836530287911,13157,23670,4236,19122,157,13,0.178960709759189,0.807858048162231,14886,-0.628897338403042
GA,Jasper County,13159,1544,4353,6016,0.256648936170213,0.723570478723404,2809,-0.466921542553192,13159,6010,1839,4121,159,13,0.305990016638935,0.685690515806988,2282,-0.379700499168053
GA,Jeff Davis County,13161,901,4102,5089,0.177048536058165,0.8060522696011,3201,-0.629003733542936,13161,5330,1271,3994,161,13,0.238461538461538,0.749343339587242,2723,-0.510881801125704
GA,Jefferson County,13163,3809,3057,6934,0.549322180559562,0.440871070089414,752,0.108451110470147,13163,7268,4238,2992,163,13,0.583104017611448,0.411667583929554,1246,0.171436433681893
GA,Jenkins County,13165,1108,1892,3034,0.365194462755438,0.623599208965063,784,-0.258404746209624,13165,3386,1487,1884,165,13,0.439161252215003,0.556408741878322,397,-0.117247489663319
GA,Johnson County,13167,1136,2519,3682,0.308527973927213,0.684139054861488,1383,-0.375611080934275,13167,3772,1305,2440,167,13,0.345970307529162,0.646871686108165,1135,-0.300901378579003
GA,Jones County,13169,3960,8304,12524,0.316192909613542,0.663046949856276,4344,-0.346854040242734,13169,12099,4272,7740,169,13,0.353087031986115,0.639722291098438,3468,-0.286635259112323
GA,Lamar County,13171,2267,5183,7575,0.299273927392739,0.684224422442244,2916,-0.384950495049505,13171,7589,2602,4896,171,13,0.342864672552379,0.645144287784952,2294,-0.302279615232573
GA,Lanier County,13173,805,1984,2861,0.281370150297099,0.693463823837819,1179,-0.41209367354072,13173,2958,1108,1812,173,13,0.374577417173766,0.612576064908722,704,-0.237998647734956
GA,Laurens County,13175,6737,12401,19448,0.346410941999177,0.637649115590292,5664,-0.291238173591115,13175,19591,7508,11947,175,13,0.383237200755449,0.609820836098208,4439,-0.226583635342759
GA,Lee County,13177,3166,10641,14106,0.22444349922019,0.754359846873671,7475,-0.529916347653481,13177,13607,3187,10310,177,13,0.234217682075402,0.757698243551113,7123,-0.523480561475711
GA,Liberty County,13179,9531,6125,16082,0.592650167889566,0.38086058947892,3406,0.211789578410645,13179,16132,10427,5558,179,13,0.646355070666997,0.344532606000496,4869,0.301822464666501
GA,Lincoln County,13181,1271,2759,4100,0.31,0.672926829268293,1488,-0.362926829268293,13181,4425,1586,2806,181,13,0.358418079096045,0.634124293785311,1220,-0.275706214689266
GA,Long County,13183,1356,2623,4109,0.330007301046483,0.63835483085909,1267,-0.308347529812606,13183,3786,1434,2300,183,13,0.378763866877971,0.607501320655045,866,-0.228737453777073
GA,Lowndes County,13185,14614,21308,36813,0.396979327954799,0.578817265639855,6694,-0.181837937685057,13185,38610,17118,21176,185,13,0.443356643356643,0.548458948458949,4058,-0.105102305102305
GA,Lumpkin County,13187,2216,9613,12324,0.179811749432003,0.780022719896138,7397,-0.600210970464135,13187,10878,2049,8633,187,13,0.188361831218974,0.793620150763008,6584,-0.605258319544034
GA,McDuffie County,13189,3699,5432,9268,0.399115235217954,0.586102719033233,1733,-0.186987483815278,13189,9585,4041,5475,189,13,0.421596244131455,0.571205007824726,1434,-0.149608763693271
GA,McIntosh County,13191,2298,3482,5893,0.389954182928899,0.590870524350925,1184,-0.200916341422026,13191,6333,2860,3405,191,13,0.451602715932417,0.537659876835623,545,-0.086057160903205
GA,Macon County,13193,2705,1540,4287,0.63097737345463,0.359225565663634,1165,0.271751807790996,13193,4781,3211,1545,193,13,0.671616816565572,0.323154151851077,1666,0.348462664714495
GA,Madison County,13195,2423,9195,11945,0.202846379238175,0.769778149853495,6772,-0.56693177061532,13195,11079,2486,8441,195,13,0.224388482715046,0.761891867497067,5955,-0.53750338478202
GA,Marion County,13197,1213,1921,3183,0.381087024819353,0.603518693056865,708,-0.222431668237512,13197,3167,1411,1731,197,13,0.445532049257973,0.546574044837386,320,-0.101041995579413
GA,Meriwether County,13199,3800,5216,9181,0.413898268162509,0.568129833351487,1416,-0.154231565188977,13199,9259,4328,4855,199,13,0.467437088238471,0.524354681931094,527,-0.056917593692623
GA,Miller County,13201,622,1888,2540,0.24488188976378,0.743307086614173,1266,-0.498425196850394,13201,2770,848,1904,201,13,0.306137184115523,0.687364620938628,1056,-0.381227436823105
GA,Mitchell County,13205,3492,4272,7857,0.444444444444444,0.543718976708667,780,-0.099274532264223,13205,8273,4081,4153,205,13,0.493291429952859,0.501994439743745,72,-0.008703009790886
GA,Monroe County,13207,3570,8821,12675,0.281656804733728,0.695936883629191,5251,-0.414280078895464,13207,12259,3779,8352,207,13,0.30826331674688,0.681295374826658,4573,-0.373032058079778
GA,Montgomery County,13209,847,2668,3560,0.237921348314607,0.749438202247191,1821,-0.511516853932584,13209,3831,1135,2662,209,13,0.296267293134952,0.694857739493605,1527,-0.398590446358653
GA,Morgan County,13211,2658,6559,9435,0.281717011128776,0.695177530471648,3901,-0.413460519342872,13211,9016,2751,6178,211,13,0.305124223602484,0.685226264418811,3427,-0.380102040816326
GA,Murray County,13213,1799,10340,12422,0.144823699887297,0.832394139430043,8541,-0.687570439542747,13213,11209,2542,8439,213,13,0.226782050138282,0.75287715228834,5897,-0.526095102150058
GA,Muscogee County,13215,39602,26901,68320,0.579654566744731,0.39375,12701,0.185904566744731,13215,70410,42458,27469,215,13,0.603010935946598,0.390129243005255,14989,0.212881692941344
GA,Newton County,13217,21936,20907,43787,0.500970607714619,0.477470482106561,1029,0.023500125608057,13217,43216,21844,20979,217,13,0.505460940392447,0.485445205479452,865,0.020015734912995
GA,Oconee County,13219,5253,12885,19030,0.276037834997373,0.677088807146611,7632,-0.401050972149238,13219,16643,4140,12222,219,13,0.248753229586012,0.73436279516914,8082,-0.485609565583128
GA,Oglethorpe County,13221,1829,4622,6650,0.275037593984962,0.695037593984962,2793,-0.42,13221,6258,1913,4250,221,13,0.305688718440396,0.67913071268776,2337,-0.373441994247363
GA,Paulding County,13223,18004,44646,64601,0.278695376232566,0.691103852881534,26642,-0.412408476648968,13223,57254,15779,40771,223,13,0.275596464875816,0.71210745100779,24992,-0.436510986131973
GA,Peach County,13225,5083,5405,10699,0.475091130012151,0.505187400691653,322,-0.030096270679503,13225,11499,6141,5280,225,13,0.534046438820767,0.45917036264023,861,0.074876076180538
GA,Pickens County,13227,1977,11651,13982,0.141396080675154,0.833285652982406,9674,-0.691889572307252,13227,12673,1975,10547,227,13,0.155843131066046,0.832241773849917,8572,-0.676398642783871
GA,Pierce County,13229,903,6301,7297,0.123749486090174,0.86350555022612,5398,-0.739756064135946,13229,6845,1124,5666,229,13,0.164207450693937,0.827757487216947,4542,-0.663550036523009
GA,Pike County,13231,1239,7273,8675,0.142824207492795,0.838386167146974,6034,-0.695561959654179,13231,8099,1355,6660,231,13,0.167304605506853,0.822323743672058,5305,-0.655019138165206
GA,Polk County,13233,2863,11006,14158,0.202217827376748,0.777369684983755,8143,-0.575151857607007,13233,13580,3608,9798,233,13,0.265684830633284,0.721502209131075,6190,-0.455817378497791
GA,Pulaski County,13235,1104,2436,3598,0.306837131739855,0.67704280155642,1332,-0.370205669816565,13235,3681,1219,2444,235,13,0.331160010866612,0.663950013583265,1225,-0.332790002716653
GA,Putnam County,13237,2745,6516,9431,0.291061393277489,0.690912946665253,3771,-0.399851553387764,13237,9205,2917,6210,237,13,0.31689299293862,0.674633351439435,3293,-0.357740358500815
GA,Quitman County,13239,461,575,1044,0.441570881226054,0.550766283524904,114,-0.109195402298851,13239,1128,612,510,239,13,0.542553191489362,0.452127659574468,102,0.090425531914894
GA,Rabun County,13241,1443,6287,7949,0.181532268209838,0.790917096490125,4844,-0.609384828280287,13241,7438,1558,5753,241,13,0.209464909922022,0.773460607690239,4195,-0.563995697768217
GA,Randolph County,13243,1597,1270,2895,0.551640759930915,0.438687392055268,327,0.112953367875648,13243,3015,1749,1249,243,13,0.580099502487562,0.414262023217247,500,0.165837479270315
GA,Richmond County,13245,48707,24441,74952,0.649842565908848,0.32608869676593,24266,0.323753869142918,13245,78865,52461,25821,245,13,0.665200025359792,0.327407595257719,26640,0.337792430102073
GA,Rockdale County,13247,23206,13463,37589,0.617361462129878,0.358163292452579,9743,0.259198169677299,13247,37879,21878,15671,247,13,0.577575965574593,0.413712083212334,6207,0.163863882362259
GA,Schley County,13249,401,1472,1909,0.210057621791514,0.771084337349398,1071,-0.561026715557884,13249,1748,448,1286,249,13,0.25629290617849,0.735697940503433,838,-0.479405034324943
GA,Screven County,13251,2300,3305,5699,0.403579575364099,0.579926302860151,1005,-0.176346727496052,13251,6093,2769,3285,251,13,0.454455933037912,0.539143279172821,516,-0.084687346134909
GA,Seminole County,13253,1186,2343,3577,0.331562762091138,0.655018171652223,1157,-0.323455409561085,13253,3765,1475,2244,253,13,0.391766268260292,0.59601593625498,769,-0.204249667994688
GA,Spalding County,13255,9347,15636,25940,0.360331534309946,0.602775636083269,6289,-0.242444101773323,13255,25057,9884,14901,255,13,0.394460629764138,0.594684120205931,5017,-0.200223490441793
GA,Stephens County,13257,1835,7682,9760,0.188012295081967,0.787090163934426,5847,-0.599077868852459,13257,9467,2123,7207,257,13,0.224252667159607,0.761276011408049,5084,-0.537023344248442
GA,Stewart County,13259,1220,805,2053,0.594252313687287,0.392109108621529,415,0.202143205065757,13259,2055,1307,740,259,13,0.636009732360097,0.360097323600973,567,0.275912408759124
GA,Sumter County,13261,5520,5275,10973,0.503052948145448,0.480725416932471,245,0.022327531212977,13261,11820,6370,5372,261,13,0.538917089678511,0.454483925549915,998,0.084433164128596
GA,Talbot County,13263,2001,1196,3243,0.617021276595745,0.368794326241135,805,0.24822695035461,13263,3490,2264,1202,263,13,0.648710601719198,0.344412607449857,1062,0.304297994269341
GA,Taliaferro County,13265,545,349,897,0.607580824972129,0.389074693422519,196,0.21850613154961,13265,961,636,321,265,13,0.661810613943809,0.334027055150884,315,0.327783558792924
GA,Tattnall County,13267,1678,5092,6879,0.243930803895915,0.74022386974851,3414,-0.496293065852595,13267,6658,1894,4702,267,13,0.28446981075398,0.706218083508561,2808,-0.421748272754581
GA,Taylor County,13269,1295,2062,3402,0.380658436213992,0.606114050558495,767,-0.225455614344503,13269,3537,1571,1948,269,13,0.444161718970879,0.550749222504948,377,-0.106587503534068
GA,Telfair County,13271,1313,2449,3794,0.34607274644175,0.645492883500264,1136,-0.299420137058513,13271,4334,1804,2479,271,13,0.416243654822335,0.571988924780803,675,-0.155745269958468
GA,Terrell County,13273,2267,1872,4179,0.542474276142618,0.447954055994257,395,0.094520220148361,13273,4398,2544,1834,273,13,0.578444747612551,0.417007730786721,710,0.16143701682583
GA,Thomas County,13275,7138,11225,18730,0.381099839829151,0.59930592632141,4087,-0.218206086492258,13275,18943,7651,11153,275,13,0.403895898220979,0.58876629889669,3502,-0.184870400675711
GA,Tift County,13277,3892,8680,12796,0.304157549234136,0.678336980306346,4788,-0.37417943107221,13277,13893,4640,9171,277,13,0.333981141582092,0.660116605484776,4531,-0.326135463902685
GA,Toombs County,13279,2338,6612,9108,0.256697408871322,0.725955204216074,4274,-0.469257795344752,13279,9333,2740,6519,279,13,0.293581913639773,0.698489231758277,3779,-0.404907318118504
GA,Towns County,13281,1206,5377,6726,0.179304192685103,0.799435028248588,4171,-0.620130835563485,13281,6159,1265,4834,281,13,0.20539048546842,0.784867673323592,3569,-0.579477187855171
GA,Treutlen County,13283,860,1808,2700,0.318518518518519,0.66962962962963,948,-0.351111111111111,13283,2738,1068,1646,283,13,0.390065741417093,0.601168736303871,578,-0.211102994886779
GA,Troup County,13285,9597,15643,25793,0.372077695498779,0.606482378940022,6046,-0.234404683441244,13285,25975,10545,15170,285,13,0.405967276227142,0.584023099133782,4625,-0.178055822906641
GA,Turner County,13287,1243,2094,3390,0.366666666666667,0.617699115044248,851,-0.251032448377581,13287,3556,1508,2027,287,13,0.424071991001125,0.570022497187851,519,-0.145950506186727
GA,Twiggs County,13289,1970,2034,4053,0.486059708857636,0.501850481125093,64,-0.015790772267456,13289,4199,2269,1905,289,13,0.540366753989045,0.453679447487497,364,0.086687306501548
GA,Union County,13291,1962,9849,12039,0.162970346374284,0.818091203588338,7887,-0.655120857214054,13291,11072,2137,8771,291,13,0.193009393063584,0.792178468208092,6634,-0.599169075144509
GA,Upson County,13293,3471,7288,10924,0.317740754302453,0.667154888319297,3817,-0.349414134016844,13293,11257,3955,7229,293,13,0.351336945900329,0.642178200230967,3274,-0.290841254330639
GA,Walker County,13295,4213,18938,23939,0.175988971970425,0.791094030661264,14725,-0.615105058690839,13295,21879,5269,16245,295,13,0.240824534942182,0.742492801316331,10976,-0.501668266374149
GA,Walton County,13297,8279,31093,40425,0.204799010513296,0.769152752009895,22814,-0.564353741496599,13297,37570,8139,29018,297,13,0.216635613521427,0.772371573063615,20879,-0.555735959542188
GA,Ware County,13299,3436,8508,12150,0.282798353909465,0.700246913580247,5072,-0.417448559670782,13299,11923,3892,7933,299,13,0.326427912438145,0.665352679694708,4041,-0.338924767256563
GA,Warren County,13301,1313,991,2332,0.56303602058319,0.424957118353345,322,0.138078902229846,13301,2522,1525,990,301,13,0.604678826328311,0.392545598731166,535,0.212133227597145
GA,Washington County,13303,4187,4138,8422,0.497150320588934,0.491332225124674,49,0.00581809546426,13303,8796,4705,4033,303,13,0.534902228285584,0.458503865393361,672,0.076398362892224
GA,Wayne County,13305,2039,8147,10376,0.196511179645335,0.78517733230532,6108,-0.588666152659985,13305,10258,2594,7553,305,13,0.252875804250341,0.736303372977188,4959,-0.483427568726847
GA,Webster County,13307,471,630,1114,0.422800718132855,0.565529622980251,159,-0.142728904847397,13307,1175,573,598,307,13,0.487659574468085,0.508936170212766,25,-0.021276595744681
GA,Wheeler County,13309,646,1421,2102,0.30732635585157,0.676022835394862,775,-0.368696479543292,13309,2160,772,1366,309,13,0.357407407407407,0.632407407407407,594,-0.275
GA,White County,13311,1672,9751,11771,0.142044006456546,0.828391810381446,8079,-0.6863478039249,13311,10471,1670,8647,311,13,0.159488110018145,0.825804603189762,6977,-0.666316493171617
GA,Whitfield County,13313,7925,21514,30362,0.261017060799684,0.708583097292668,13589,-0.447566036492985,13313,26828,7193,19290,313,13,0.268115401818995,0.719024899358879,12097,-0.450909497539884
GA,Wilcox County,13315,852,2096,2973,0.286579212916246,0.705011772620249,1244,-0.418432559704003,13315,3124,1059,2050,315,13,0.33898847631242,0.656209987195903,991,-0.317221510883483
GA,Wilkes County,13317,1844,2569,4470,0.412527964205817,0.574720357941834,725,-0.162192393736018,13317,4746,2080,2628,317,13,0.43826380109566,0.553729456384324,548,-0.115465655288664
GA,Wilkinson County,13319,1893,2332,4276,0.442703461178672,0.545369504209542,439,-0.10266604303087,13319,4448,2180,2245,319,13,0.490107913669065,0.504721223021583,65,-0.014613309352518
GA,Worth County,13321,2015,6144,8266,0.243769658843455,0.743285748850714,4129,-0.499516090007259,13321,8410,2486,5864,321,13,0.295600475624257,0.697265160523187,3378,-0.40166468489893
HI,Hawaii County,15001,41258,17500,64865,0.636059508209358,0.269791104601865,23758,0.366268403607492,15001,62653,46670,14541,1,15,0.744896493384196,0.232087848945781,32129,0.512808644438415
HI,Honolulu County,15003,175634,90296,285683,0.614786319101942,0.316070609731766,85338,0.298715709370176,15003,292925,201803,87255,3,15,0.688923785952036,0.297874882649142,114548,0.391048903302893
HI,Kauai County,15007,16456,7574,26335,0.624871843554205,0.287602050503133,8882,0.337269793051073,15007,25369,18638,6121,7,15,0.734676179589262,0.241278726004178,12517,0.493397453585084
HI,Maui County,15009,33479,13445,51942,0.644545839590312,0.258846405606253,20034,0.385699433984059,15009,48547,35979,11577,9,15,0.741116855830432,0.238469936350341,24402,0.502646919480091
ID,Ada County,16001,75676,93748,195587,0.386917330906451,0.479316109966409,18072,-0.092398779059958,16001,180361,77043,97471,1,16,0.427159973608485,0.540421709793137,20428,-0.113261736184652
ID,Adams County,16003,415,1556,2183,0.190105359596885,0.712780577187357,1141,-0.522675217590472,16003,2060,577,1413,3,16,0.280097087378641,0.685922330097087,836,-0.405825242718447
ID,Bannock County,16005,10342,17180,33405,0.309594372099985,0.514294267325251,6838,-0.204699895225266,16005,35260,13214,21010,5,16,0.374758933635848,0.59585933068633,7796,-0.221100397050482
ID,Bear Lake County,16007,255,2203,2928,0.087090163934426,0.752390710382514,1948,-0.665300546448087,16007,2822,302,2489,7,16,0.107016300496102,0.881998582565556,2187,-0.774982282069454
ID,Benewah County,16009,780,3101,4192,0.186068702290076,0.739742366412214,2321,-0.553673664122137,16009,3884,1164,2596,9,16,0.299691040164779,0.668383110195675,1432,-0.368692070030896
ID,Bingham County,16011,2924,10907,16625,0.17587969924812,0.65606015037594,7983,-0.48018045112782,16011,17603,3822,13440,11,16,0.217122081463387,0.763506220530591,9618,-0.546384139067204
ID,Blaine County,16013,6416,3340,10723,0.598340016786347,0.311479996269701,3076,0.286860020516646,16013,10194,5992,3939,13,16,0.587796743182264,0.386403766921719,2053,0.201392976260545
ID,Boise County,16015,777,2673,3812,0.203830010493179,0.701206715634837,1896,-0.497376705141658,16015,3345,953,2284,15,16,0.284902840059791,0.682810164424514,1331,-0.397907324364724
ID,Bonner County,16017,5140,10220,16815,0.305679452869462,0.607790663098424,5080,-0.302111210228962,16017,18536,6500,11367,17,16,0.350668968493742,0.613239102287441,4867,-0.262570133793699
ID,Bonneville County,16019,8930,26699,44212,0.201981362526011,0.603885822853524,17769,-0.401904460327513,16019,43302,9929,32336,19,16,0.229296568287839,0.746755346173387,22407,-0.517458777885548
ID,Boundary County,16021,933,3789,5150,0.181165048543689,0.735728155339806,2856,-0.554563106796117,16021,4544,1225,3138,21,16,0.269586267605634,0.690580985915493,1913,-0.420994718309859
ID,Butte County,16023,160,914,1230,0.130081300813008,0.743089430894309,754,-0.613008130081301,16023,1286,258,1001,23,16,0.200622083981337,0.778382581648523,743,-0.577760497667185
ID,Camas County,16025,110,410,599,0.183639398998331,0.684474123539232,300,-0.500834724540901,16025,578,159,402,25,16,0.275086505190311,0.695501730103806,243,-0.420415224913495
ID,Canyon County,16027,16683,46755,72007,0.231685808324191,0.649311872456845,30072,-0.417626064132654,16027,66090,19866,44369,27,16,0.300590104403087,0.671342109244969,24503,-0.370752004841882
ID,Caribou County,16029,271,2275,3035,0.089291598023064,0.749588138385502,2004,-0.660296540362438,16029,3050,385,2608,29,16,0.126229508196721,0.855081967213115,2223,-0.728852459016393
ID,Cassia County,16031,1036,5949,8178,0.126681340180973,0.727439471753485,4913,-0.600758131572512,16031,8387,1093,7150,31,16,0.130320734470013,0.852509836651961,6057,-0.722189102181948
ID,Clark County,16033,44,203,283,0.15547703180212,0.717314487632509,159,-0.561837455830389,16033,328,66,235,33,16,0.201219512195122,0.716463414634146,169,-0.515243902439024
ID,Clearwater County,16035,704,2852,3801,0.185214417258616,0.750328860826098,2148,-0.565114443567482,16035,3696,1032,2541,35,16,0.279220779220779,0.6875,1509,-0.408279220779221
ID,Custer County,16037,427,1777,2413,0.176958143389971,0.736427683381683,1350,-0.559469539991712,16037,2352,530,1744,37,16,0.225340136054422,0.741496598639456,1214,-0.516156462585034
ID,Elmore County,16039,1814,5816,8519,0.212935790585749,0.682709238173494,4002,-0.469773447587745,16039,8001,2513,5227,39,16,0.31408573928259,0.653293338332708,2714,-0.339207599050119
ID,Franklin County,16041,385,3901,5499,0.070012729587198,0.709401709401709,3516,-0.639388979814512,16041,5600,325,5195,41,16,0.058035714285714,0.927678571428572,4870,-0.869642857142857
ID,Fremont County,16043,651,4091,5714,0.113930696534827,0.715960798039902,3440,-0.602030101505075,16043,5802,810,4907,43,16,0.139607032057911,0.845742847294037,4097,-0.706135815236126
ID,Gem County,16045,1229,5980,7952,0.1545523138833,0.752012072434608,4751,-0.597459758551308,16045,7490,1957,5311,45,16,0.26128170894526,0.709078771695594,3354,-0.447797062750334
ID,Gooding County,16047,930,3743,5191,0.179156231939896,0.721055673280678,2813,-0.541899441340782,16047,5118,1287,3696,47,16,0.251465416178195,0.722157092614302,2409,-0.470691676436108
ID,Idaho County,16049,1196,6441,8223,0.14544570108233,0.783290769792047,5245,-0.637845068709717,16049,7749,1722,5821,49,16,0.222222222222222,0.751193702413215,4099,-0.528971480190992
ID,Jefferson County,16051,976,8436,11471,0.08508412518525,0.735419754162671,7460,-0.650335628977421,16051,11381,1303,9895,51,16,0.114489060715227,0.869431508654775,8592,-0.754942447939548
ID,Jerome County,16053,2117,7347,10667,0.198462548045374,0.688759726258554,5230,-0.490297178213181,16053,6681,1699,4804,53,16,0.254303248016764,0.719054033827271,3105,-0.464750785810507
ID,Kootenai County,16055,16264,44449,66286,0.245361011374951,0.670563919983104,28185,-0.425202908608152,16055,59764,18824,39347,55,16,0.314972224081387,0.658372933538585,20523,-0.343400709457198
ID,Latah County,16057,8093,7255,18146,0.445993607406591,0.399812630882839,838,0.046180976523752,16057,16759,8306,7589,57,16,0.495614296795752,0.452831314517573,717,0.042782982278179
ID,Lemhi County,16059,733,3011,4068,0.180186823992134,0.740167158308751,2278,-0.559980334316618,16059,4109,960,3029,59,16,0.233633487466537,0.737162326600146,2069,-0.503528839133609
ID,Lewis County,16061,270,1202,1590,0.169811320754717,0.755974842767296,932,-0.586163522012579,16061,1612,396,1173,61,16,0.245657568238213,0.727667493796526,777,-0.482009925558313
ID,Lincoln County,16063,360,1184,1748,0.205949656750572,0.677345537757437,824,-0.471395881006865,16063,1622,429,1141,63,16,0.264488286066584,0.703452527743526,712,-0.438964241676942
ID,Madison County,16065,1201,8941,15687,0.07656020909033,0.569962389239498,7740,-0.493402180149168,16065,14412,832,13445,65,16,0.057729669719678,0.932903136275326,12613,-0.875173466555648
ID,Minidoka County,16067,1167,4887,6870,0.169868995633188,0.711353711790393,3720,-0.541484716157205,16067,6973,1390,5442,67,16,0.199340312634447,0.78043883550839,4052,-0.581098522873942
ID,Nez Perce County,16069,4828,10699,17195,0.280779296307066,0.622215760395464,5871,-0.341436464088398,16069,16848,6451,9967,69,16,0.382894112060779,0.591583570750237,3516,-0.208689458689459
ID,Oneida County,16071,184,1531,2068,0.088974854932302,0.740328820116054,1347,-0.651353965183752,16071,2089,217,1838,71,16,0.103877453326951,0.879846816658688,1621,-0.775969363331738
ID,Owyhee County,16073,591,3052,3920,0.150765306122449,0.778571428571429,2461,-0.62780612244898,16073,3723,833,2794,73,16,0.223744292237443,0.750470051034112,1961,-0.526725758796669
ID,Payette County,16075,892,4306,5703,0.156408907592495,0.755041206382606,3414,-0.59863229879011,16075,8495,2271,6004,75,16,0.267333725721012,0.706768687463214,3733,-0.439434961742201
ID,Power County,16077,699,1666,2758,0.253444525018129,0.604060913705584,967,-0.350616388687455,16077,2903,982,1870,77,16,0.338270754392008,0.644161212538753,888,-0.305890458146745
ID,Shoshone County,16079,1384,3297,5120,0.2703125,0.6439453125,1913,-0.3736328125,16079,5148,2277,2699,79,16,0.442307692307692,0.524281274281274,422,-0.081973581973582
ID,Teton County,16081,2157,2161,4966,0.434353604510673,0.43515908175594,4,-0.000805477245268,16081,4523,1926,2458,81,16,0.425823568428034,0.543444616405041,532,-0.117621047977006
ID,Twin Falls County,16083,6844,21063,31893,0.214592543818393,0.660427052958329,14219,-0.445834509139937,16083,28142,7541,19773,83,16,0.267962476014498,0.702615308080449,12232,-0.434652832065951
ID,Valley County,16085,1913,2906,5349,0.35763694148439,0.543279117592073,993,-0.185642176107684,16085,4919,2095,2664,85,16,0.42589957308396,0.541573490546859,569,-0.115673917462899
ID,Washington County,16087,776,3283,4454,0.174225415356982,0.737090255949708,2507,-0.562864840592726,16087,4330,1104,3128,87,16,0.254965357967667,0.722401847575058,2024,-0.46743648960739
IL,Adams County,17001,7633,22732,31770,0.240258105130626,0.715517784073025,15099,-0.475259678942398,17001,30538,9627,20371,1,17,0.315246578033925,0.667070535071059,10744,-0.351823957037134
IL,Alexander County,17003,1262,1496,2820,0.447517730496454,0.530496453900709,234,-0.082978723404255,17003,3495,1961,1485,3,17,0.561087267525036,0.424892703862661,476,0.136194563662375
IL,Bond County,17005,2066,4884,7462,0.276869471991423,0.654516215491825,2818,-0.377646743500402,17005,7316,3016,4091,5,17,0.412247129579005,0.559185347184254,1075,-0.146938217605249
IL,Boone County,17007,8952,12261,22604,0.396036099805344,0.542426119270926,3309,-0.146390019465581,17007,21333,9868,11084,7,17,0.462569727651995,0.519570618290911,1216,-0.057000890638916
IL,Brown County,17009,475,1776,2336,0.20333904109589,0.76027397260274,1301,-0.556934931506849,17009,2362,787,1511,9,17,0.333192209991533,0.639712108382726,724,-0.306519898391194
IL,Bureau County,17011,6010,9264,16303,0.368643807888119,0.568238974421886,3254,-0.199595166533767,17011,16599,8118,8151,11,17,0.489065606361829,0.491053677932406,33,-0.001988071570577
IL,Calhoun County,17013,739,1719,2556,0.289123630672926,0.672535211267606,980,-0.383411580594679,17013,2574,1079,1439,13,17,0.419191919191919,0.559052059052059,360,-0.13986013986014
IL,Carroll County,17015,2437,4428,7354,0.331384280663584,0.602121294533587,1991,-0.270737013870003,17015,7370,3658,3551,15,17,0.496336499321574,0.481818181818182,107,0.014518317503392
IL,Cass County,17017,1617,3216,5054,0.31994459833795,0.636327661258409,1599,-0.316383062920459,17017,4858,2050,2707,17,17,0.421984355701935,0.557225195553726,657,-0.135240839851791
IL,Champaign County,17019,49694,33235,89196,0.557132606843356,0.372606394905601,16459,0.184526211937755,17019,77620,40378,35086,19,17,0.52020097912909,0.45202267456841,5292,0.06817830456068
IL,Christian County,17021,3982,10522,15310,0.26009144350098,0.687263226649249,6540,-0.427171783148269,17021,14682,5487,8873,21,17,0.373722926031876,0.604345457022204,3386,-0.230622530990328
IL,Clark County,17023,1873,5620,7819,0.23954469881059,0.7187619900243,3747,-0.47921729121371,17023,7843,2587,5138,23,17,0.329848272344766,0.655106464363126,2551,-0.32525819201836
IL,Clay County,17025,1014,5009,6278,0.161516406498885,0.797865562280981,3995,-0.636349155782096,17025,5899,1581,4184,25,17,0.268011527377522,0.709272758094592,2603,-0.441261230717071
IL,Clinton County,17027,3939,12394,17268,0.22810979847116,0.717743803567292,8455,-0.489634005096131,17027,16394,5577,10493,27,17,0.340185433695254,0.640051238257899,4916,-0.299865804562645
IL,Coles County,17029,7285,12985,21580,0.33758109360519,0.601714550509731,5700,-0.264133456904541,17029,21338,9252,11623,29,17,0.433592651607461,0.544708969912832,2371,-0.111116318305371
IL,Cook County,17031,1528582,440213,2055215,0.743757709047472,0.21419316227256,1088369,0.529564546774912,17031,1944401,1439123,479204,31,17,0.740136936773845,0.246453277898952,959919,0.493683658874893
IL,Crawford County,17033,1969,6146,8507,0.231456447631362,0.722463853297285,4177,-0.491007405665922,17033,8598,2855,5577,33,17,0.332053966038614,0.648639218422889,2722,-0.316585252384275
IL,Cumberland County,17035,1028,4200,5513,0.186468347542173,0.76183566116452,3172,-0.575367313622347,17035,5290,1640,3506,35,17,0.310018903591682,0.662759924385633,1866,-0.352741020793951
IL,DeKalb County,17037,20348,19051,42605,0.477596526229316,0.447154089895552,1297,0.030442436333764,17037,41020,21171,18906,37,17,0.51611409068747,0.460897123354461,2265,0.055216967333008
IL,De Witt County,17039,1907,5072,7469,0.255321997590039,0.679073503815772,3165,-0.423751506225733,17039,7338,2598,4576,39,17,0.354047424366312,0.623603161624421,1978,-0.269555737258108
IL,Douglas County,17041,1946,5695,8089,0.240573618494251,0.704042526888367,3749,-0.463468908394115,17041,7889,2426,5331,41,17,0.307516795538091,0.675751045759919,2905,-0.368234250221828
IL,DuPage County,17043,222499,164355,412929,0.538831130775509,0.398022420319232,58144,0.140808710456277,17043,397173,197411,193333,43,17,0.497040332550299,0.486772766527433,4078,0.010267566022867
IL,Edgar County,17045,1778,5634,7783,0.228446614416035,0.723885391237312,3856,-0.495438776821277,17045,7810,2563,5125,45,17,0.328169014084507,0.656209987195903,2562,-0.328040973111396
IL,Edwards County,17047,432,2777,3312,0.130434782608696,0.838466183574879,2345,-0.708031400966184,17047,3225,754,2402,47,17,0.233798449612403,0.744806201550388,1648,-0.511007751937985
IL,Effingham County,17049,3071,13613,17428,0.176210695432637,0.781099380307551,10542,-0.604888684874914,17049,16595,3855,12491,49,17,0.232298885206387,0.752696595360048,8636,-0.520397710153661
IL,Fayette County,17051,1814,7363,9515,0.190646347871781,0.773830793483973,5549,-0.583184445612191,17051,8963,2848,5950,51,17,0.317750753096062,0.663840232065157,3102,-0.346089478969095
IL,Ford County,17053,1410,4474,6289,0.224200985848307,0.711400858642073,3064,-0.487199872793767,17053,6000,1654,4225,53,17,0.275666666666667,0.704166666666667,2571,-0.4285
IL,Franklin County,17055,4711,13101,18533,0.254195219338477,0.706901203259051,8390,-0.452705983920574,17055,17891,7245,10253,55,17,0.404952210608686,0.573081437594321,3008,-0.168129226985635
IL,Fulton County,17057,6118,8482,15609,0.391953360240887,0.543404446152861,2364,-0.151451085911974,17057,15337,8324,6622,57,17,0.542739779617917,0.431766316750342,1702,0.110973462867575
IL,Gallatin County,17059,656,1942,2691,0.243775548123374,0.72166480862133,1286,-0.477889260497956,17059,2569,1028,1492,59,17,0.400155702608019,0.580770727909693,464,-0.180615025301674
IL,Greene County,17061,1202,4139,5542,0.216889209671599,0.746842295200289,2937,-0.52995308552869,17061,5614,2023,3446,61,17,0.360349127182045,0.613822586391165,1423,-0.25347345920912
IL,Grundy County,17063,8021,13417,22891,0.350399720414137,0.586125551526801,5396,-0.235725831112664,17063,20956,9319,11198,63,17,0.444693643825157,0.534357701851498,1879,-0.089664058026341
IL,Hamilton County,17065,800,3205,4143,0.19309678976587,0.773594013999517,2405,-0.580497224233647,17065,3935,1266,2566,65,17,0.321728081321474,0.652096569250318,1300,-0.330368487928844
IL,Hancock County,17067,1744,5713,7818,0.223074955231517,0.73074955231517,3969,-0.507674597083653,17067,8229,3246,4810,67,17,0.394458621946774,0.584518167456556,1564,-0.190059545509782
IL,Hardin County,17069,419,1650,2133,0.196436943272386,0.773558368495077,1231,-0.577121425222691,17069,2330,742,1535,69,17,0.318454935622318,0.658798283261803,793,-0.340343347639485
IL,Henderson County,17071,1151,2153,3480,0.330747126436782,0.61867816091954,1002,-0.287931034482759,17071,3563,1977,1538,71,17,0.554869492001123,0.431658714566377,439,0.123210777434746
IL,Henry County,17073,8835,13962,24232,0.364600528227138,0.57618025751073,5127,-0.211579729283592,17073,24279,12316,11564,73,17,0.507269656905144,0.476296387824869,752,0.030973269080275
IL,Iroquois County,17075,2496,9728,12923,0.193144006809564,0.7527663855142,7232,-0.559622378704635,17075,12770,3408,9115,75,17,0.266875489428348,0.713782302270948,5707,-0.4469068128426
IL,Jackson County,17077,11619,10889,24509,0.474070749520584,0.44428577257334,730,0.029784976947244,17077,21190,11306,9130,77,17,0.533553563001416,0.430863614912695,2176,0.102689948088721
IL,Jasper County,17079,924,3973,5104,0.181034482758621,0.778409090909091,3049,-0.59737460815047,17079,5038,1434,3511,79,17,0.284636760619293,0.696903533148075,2077,-0.412266772528781
IL,Jefferson County,17081,4408,11681,16818,0.262100130812225,0.694553454631942,7273,-0.432453323819717,17081,16303,6080,9805,81,17,0.37293749616635,0.601423050972214,3725,-0.228485554805864
IL,Jersey County,17083,2673,7737,10909,0.245027041892016,0.709230910257585,5064,-0.46420386836557,17083,9940,3656,6032,83,17,0.367806841046278,0.606841046277666,2376,-0.239034205231388
IL,Jo Daviess County,17085,4452,6113,11177,0.398317974411738,0.546926724523575,1661,-0.148608750111837,17085,11411,5660,5529,85,17,0.496012619402331,0.484532468670581,131,0.01148015073175
IL,Johnson County,17087,1135,4644,6017,0.188632208741898,0.771813195944823,3509,-0.583180987202925,17087,5666,1571,3959,87,17,0.27726791387222,0.698729262266149,2388,-0.421461348393929
IL,Kane County,17089,99389,82087,193500,0.513638242894057,0.424222222222222,17302,0.089416020671835,17089,183631,91120,89502,89,17,0.49621251313776,0.487401364693325,1618,0.008811148444435
IL,Kankakee County,17091,18908,25081,46556,0.40613454764155,0.538727553913566,6173,-0.132593006272016,17091,45452,21574,23115,91,17,0.474654580656517,0.508558479274839,1541,-0.033903898618323
IL,Kendall County,17093,23392,24152,50815,0.460336514808619,0.475292728525042,760,-0.014956213716422,17093,45042,21219,23076,93,17,0.471093645930465,0.512321832955908,1857,-0.041228187025443
IL,Knox County,17095,9939,10658,21964,0.452513203423784,0.485248588599526,719,-0.032735385175742,17095,22517,12993,9133,95,17,0.577030687924679,0.405604654261225,3860,0.171426033663454
IL,Lake County,17097,168186,108608,293574,0.572891332338695,0.369951017460674,59578,0.20294031487802,17097,284032,151552,128609,97,17,0.533573681838666,0.452797572104552,22943,0.080776109734115
IL,LaSalle County,17099,19277,26269,48447,0.397898734699775,0.542221396577703,6992,-0.144322661877929,17099,47146,23023,23207,99,17,0.488334111059263,0.492236881177618,184,-0.003902770118356
IL,Lawrence County,17101,1288,4517,6039,0.213280344427885,0.747971518463322,3229,-0.534691174035436,17101,5984,2010,3853,101,17,0.335895721925134,0.643883689839572,1843,-0.307987967914439
IL,Lee County,17103,5499,8597,15215,0.361419651659546,0.565034505422281,3098,-0.203614853762734,17103,15275,6932,8046,103,17,0.453813420621931,0.526743044189853,1114,-0.072929623567922
IL,Livingston County,17105,4005,10197,15096,0.265302066772655,0.675476947535771,6192,-0.410174880763116,17105,15019,5014,9745,105,17,0.333843797856049,0.648844796590985,4731,-0.315000998734936
IL,Logan County,17107,3301,8167,12130,0.272135201978566,0.673289365210223,4866,-0.401154163231657,17107,12037,3974,7835,107,17,0.330148708149871,0.650909695106754,3861,-0.320760986956883
IL,McDonough County,17109,5278,6789,12910,0.408830364058869,0.525871417505809,1511,-0.11704105344694,17109,12439,5957,6142,109,17,0.478897017445132,0.493769595626658,185,-0.014872578181526
IL,McHenry County,17111,59827,71117,140145,0.426893574512113,0.507452995112205,11290,-0.080559420600093,17111,133589,59691,71488,111,17,0.446825711697819,0.535133880783597,11797,-0.088308169085778
IL,McLean County,17113,35918,37081,78995,0.454687005506678,0.469409456294702,1163,-0.014722450788025,17113,72756,31590,39638,113,17,0.43419099455715,0.544807301116059,8048,-0.110616306558909
IL,Macon County,17115,18211,26782,47283,0.385148996468075,0.566419220438635,8571,-0.18127022397056,17115,48742,22688,25249,115,17,0.465471256821632,0.518013212424603,2561,-0.052541955602971
IL,Macoupin County,17117,6532,14194,21881,0.298523833462822,0.648690644851698,7662,-0.350166811388876,17117,20947,9440,10909,117,17,0.450661192533537,0.520790566668258,1469,-0.070129374134721
IL,Madison County,17119,50336,70295,127902,0.393551312723804,0.549600475363951,19959,-0.156049162640146,17119,122203,58813,60481,119,17,0.481272963838858,0.494922383247547,1668,-0.013649419408689
IL,Marion County,17121,4231,11677,16600,0.254879518072289,0.703433734939759,7446,-0.44855421686747,17121,15728,6210,9229,121,17,0.394837232960325,0.586787894201424,3019,-0.191950661241099
IL,Marshall County,17123,1784,3776,5903,0.302219210570896,0.639674741656785,1992,-0.337455531085889,17123,5842,2452,3287,123,17,0.419719274221157,0.562649777473468,835,-0.142930503252311
IL,Mason County,17125,2008,4051,6433,0.312140525415825,0.62972174724079,2043,-0.317581221824965,17125,6272,2867,3265,125,17,0.457110969387755,0.520567602040816,398,-0.063456632653061
IL,Massac County,17127,1555,4844,6633,0.234433891150309,0.730287954168551,3289,-0.495854063018242,17127,6492,2092,4278,127,17,0.322242760320394,0.658964879852126,2186,-0.336722119531731
IL,Menard County,17129,1808,4230,6423,0.281488401058695,0.658570761326483,2422,-0.377082360267788,17129,6142,2095,3944,129,17,0.341094106154347,0.64213611201563,1849,-0.301042005861283
IL,Mercer County,17131,3061,4800,8417,0.363668765593442,0.570274444576452,1739,-0.20660567898301,17131,8525,4503,3874,131,17,0.528211143695015,0.454428152492669,629,0.073782991202346
IL,Monroe County,17133,5522,12614,19074,0.289504036908881,0.661319073083779,7092,-0.371815036174898,17133,17407,6205,10879,133,17,0.356465789624864,0.624978456942609,4674,-0.268512667317746
IL,Montgomery County,17135,3490,8616,12829,0.272039909579858,0.67160339855016,5126,-0.399563488970302,17135,12120,5053,6771,135,17,0.416914191419142,0.558663366336634,1718,-0.141749174917492
IL,Morgan County,17137,4693,9060,14607,0.321284315739029,0.6202505647977,4367,-0.29896624905867,17137,14071,5792,7962,137,17,0.411626750053301,0.565844645014569,2170,-0.154217894961268
IL,Moultrie County,17139,1476,4453,6209,0.237719439523273,0.717184731840876,2977,-0.479465292317603,17139,6052,2142,3781,139,17,0.353932584269663,0.624752148050231,1639,-0.270819563780568
IL,Ogle County,17141,8025,14344,23798,0.337213211194218,0.602739726027397,6319,-0.265526514833179,17141,23342,9504,13409,141,17,0.407163053722903,0.574458058435438,3905,-0.167295004712535
IL,Peoria County,17143,37436,35299,77465,0.483263409281611,0.455676757245208,2137,0.027586652036404,17143,78060,40050,36617,143,17,0.513066871637202,0.469087881117089,3433,0.043978990520113
IL,Perry County,17145,2433,6816,9706,0.250669688852256,0.702246033381414,4383,-0.451576344529157,17145,9533,3813,5497,145,17,0.399979020245463,0.576628553445925,1684,-0.176649533200462
IL,Piatt County,17147,2633,5623,8899,0.295875941116979,0.631868749297674,2990,-0.335992808180694,17147,8697,3081,5412,147,17,0.354260089686099,0.622283546050362,2331,-0.268023456364263
IL,Pike County,17149,1412,5749,7458,0.189326897291499,0.770850093858943,4337,-0.581523196567444,17149,7275,2276,4853,149,17,0.312852233676976,0.667079037800687,2577,-0.354226804123711
IL,Pope County,17151,374,1678,2132,0.175422138836773,0.787054409005629,1304,-0.611632270168855,17151,2219,649,1511,151,17,0.292474087426769,0.680937359170798,862,-0.388463271744029
IL,Pulaski County,17153,817,1583,2473,0.330367974120501,0.640113222806308,766,-0.309745248685807,17153,3001,1389,1562,153,17,0.462845718093969,0.520493168943685,173,-0.057647450849717
IL,Putnam County,17155,1143,1762,3076,0.371586475942783,0.572821846553966,619,-0.201235370611183,17155,3132,1558,1500,155,17,0.497445721583653,0.478927203065134,58,0.018518518518519
IL,Randolph County,17157,3421,9992,14032,0.243799885974914,0.712086659064994,6571,-0.46828677309008,17157,14380,5753,8284,157,17,0.400069541029207,0.576077885952712,2531,-0.176008344923505
IL,Richland County,17159,1579,5736,7630,0.20694626474443,0.751769331585845,4157,-0.544823066841415,17159,7274,2360,4750,159,17,0.324443222436074,0.653010723123453,2390,-0.32856750068738
IL,Rock Island County,17161,32258,26969,62971,0.512267551730161,0.428276508233949,5289,0.083991043496213,17161,64880,39081,24888,161,17,0.602358199753391,0.383600493218249,14193,0.218757706535142
IL,St. Clair County,17163,60180,53479,119201,0.504861536396507,0.448645565053984,6701,0.056215971342522,17163,118379,66749,49610,163,17,0.563858454624553,0.419077708039433,17139,0.144780746585121
IL,Saline County,17165,2551,8248,11234,0.227078511661029,0.734199750756632,5697,-0.507121239095603,17165,10713,3697,6803,165,17,0.345094744702698,0.635022869410996,3106,-0.289928124708298
IL,Sangamon County,17167,40731,49823,96472,0.422205406750145,0.51645036901899,9092,-0.094244962268845,17167,94032,41961,50131,167,17,0.446241704951506,0.533127020588736,8170,-0.08688531563723
IL,Schuyler County,17169,1074,2523,3792,0.283227848101266,0.665348101265823,1449,-0.382120253164557,17169,3882,1726,2062,169,17,0.444616177228233,0.531169500257599,336,-0.086553323029366
IL,Scott County,17171,528,1965,2583,0.204413472706156,0.760743321718931,1437,-0.556329849012776,17171,2554,910,1586,171,17,0.356303837118246,0.620986687548943,676,-0.264682850430697
IL,Shelby County,17173,2279,8209,10912,0.208852639296188,0.752291055718475,5930,-0.543438416422287,17173,10383,3336,6837,173,17,0.321294423577001,0.658480208032361,3501,-0.33718578445536
IL,Stark County,17175,748,1777,2707,0.276320650166236,0.656446250461766,1029,-0.38012560029553,17175,2661,1095,1527,175,17,0.411499436302142,0.573844419391206,432,-0.162344983089064
IL,Stephenson County,17177,7531,10845,19525,0.385710627400768,0.555441741357234,3314,-0.169731113956466,17177,17029,7954,8742,177,17,0.467085559927183,0.513359563098244,788,-0.046274003171061
IL,Tazewell County,17179,20568,38620,63347,0.324687830520782,0.609657915923406,18052,-0.284970085402624,17179,60903,24385,35266,179,17,0.400390785347191,0.579051935044251,10881,-0.178661149697059
IL,Union County,17181,2389,5780,8514,0.280596664317595,0.678881841672539,3391,-0.398285177354945,17181,8274,3135,4951,181,17,0.378897751994199,0.598380468938845,1816,-0.219482716944646
IL,Vermilion County,17183,9876,18582,29799,0.331420517467029,0.623577972415182,8706,-0.292157454948153,17183,26153,10773,14888,183,17,0.411922150422514,0.569265476235996,4115,-0.157343325813482
IL,Wabash County,17185,1146,4039,5402,0.212143650499815,0.74768604220659,2893,-0.535542391706775,17185,5127,1588,3473,185,17,0.309732787204993,0.677394187634094,1885,-0.367661400429101
IL,Warren County,17187,2983,4267,7700,0.387402597402597,0.554155844155844,1284,-0.166753246753247,17187,7476,3893,3460,187,17,0.520733012306046,0.462814339218834,433,0.057918673087212
IL,Washington County,17189,1446,5566,7376,0.196041214750542,0.754609544468547,4120,-0.558568329718004,17189,7398,2448,4787,189,17,0.330900243309002,0.647066774804001,2339,-0.316166531494999
IL,Wayne County,17191,1048,6963,8256,0.126937984496124,0.843386627906977,5915,-0.716448643410853,17191,7676,1514,5984,191,17,0.197238144867118,0.779572694111516,4470,-0.582334549244398
IL,White County,17193,1412,5639,7289,0.193716559198793,0.773631499519824,4227,-0.579914940321032,17193,7059,2187,4729,193,17,0.309817254568636,0.669924918543703,2542,-0.360107663975067
IL,Whiteside County,17195,11005,12597,25210,0.436533121777073,0.499682665608885,1592,-0.063149543831813,17195,21492,12393,8676,195,17,0.576633165829146,0.403685092127303,3717,0.172948073701843
IL,Will County,17197,146230,129726,291010,0.502491323322223,0.445778495584344,16504,0.056712827737878,17197,249708,127522,118366,197,17,0.510684479472023,0.474017652618258,9156,0.036666826853765
IL,Williamson County,17199,8539,21503,31422,0.271752275475781,0.684329450703329,12964,-0.412577175227548,17199,29079,10622,17880,199,17,0.365280786822105,0.614876715155267,7258,-0.249595928333161
IL,Winnebago County,17201,52595,53922,113027,0.465331292523026,0.477071850088917,1327,-0.011740557565891,17201,116101,60334,53722,201,17,0.519668219911973,0.462717806048182,6612,0.056950413863791
IL,Woodford County,17203,5068,13180,19389,0.261385321574088,0.679766878126773,8112,-0.418381556552685,17203,18848,5564,12947,203,17,0.295203735144312,0.686916383701188,7383,-0.391712648556876
IN,Adams County,18001,2802,9642,13039,0.214893780197868,0.739473886034205,6840,-0.524580105836337,18001,12998,3800,8936,1,18,0.292352669641483,0.687490383135867,5136,-0.395137713494384
IN,Allen County,18003,55222,83801,145787,0.378785488418035,0.574818056479659,28579,-0.196032568061624,18003,146405,59834,84378,3,18,0.40868822786107,0.576332775519962,24544,-0.167644547658891
IN,Bartholomew County,18005,9841,20637,32389,0.303837722683627,0.637160764457069,10796,-0.333323041773442,18005,29313,10622,18083,5,18,0.36236482106915,0.616893528468598,7461,-0.254528707399447
IN,Benton County,18007,860,2579,3654,0.23535851122058,0.705801860974275,1719,-0.470443349753695,18007,3577,1159,2329,7,18,0.324014537321778,0.651104277327369,1170,-0.327089740005591
IN,Blackford County,18009,1243,3349,4822,0.257776856076317,0.694525093322273,2106,-0.436748237245956,18009,4740,1927,2710,9,18,0.406540084388186,0.571729957805907,783,-0.165189873417721
IN,Boone County,18011,10181,19654,32061,0.317550918561492,0.613018932659618,9473,-0.295468014098125,18011,27725,8326,18807,11,18,0.300306582506763,0.67834084761046,10481,-0.378034265103697
IN,Brown County,18013,2518,5015,7908,0.318411734951947,0.634167931208902,2497,-0.315756196256955,18013,7590,3056,4330,13,18,0.402635046113307,0.570487483530962,1274,-0.167852437417655
IN,Carroll County,18015,1891,6273,8609,0.219653850621443,0.728656057614125,4382,-0.509002206992682,18015,7793,2631,4993,15,18,0.337610676247915,0.640703195175157,2362,-0.303092518927242
IN,Cass County,18017,3758,9697,14135,0.265864874425186,0.686027591085957,5939,-0.420162716660771,18017,14137,5365,8432,17,18,0.379500601259107,0.59644903444861,3067,-0.216948433189503
IN,Clark County,18019,18791,30012,51104,0.367701158422041,0.587273011897307,11221,-0.219571853475266,18019,47062,20775,25422,19,18,0.441438952870681,0.54018103777995,4647,-0.098742084909269
IN,Clay County,18021,2306,8528,11259,0.204813926636469,0.757438493649525,6222,-0.552624567013056,18021,10922,3630,7065,21,18,0.33235671122505,0.646859549533053,3435,-0.314502838308002
IN,Clinton County,18023,2819,8530,11896,0.236970410221923,0.717047747141896,5711,-0.480077336919973,18023,9879,3307,6338,23,18,0.334750480817897,0.641562911225833,3031,-0.306812430407936
IN,Crawford County,18025,1323,3013,4591,0.288172511435417,0.656284033979525,1690,-0.368111522544108,18025,4586,2040,2418,25,18,0.444832097688618,0.52725686873092,378,-0.082424771042303
IN,Daviess County,18027,1800,8545,10736,0.167660208643815,0.795920268256334,6745,-0.628260059612519,18027,10246,2437,7638,27,18,0.2378489166504,0.745461643568222,5201,-0.507612726917822
IN,Dearborn County,18029,4883,18110,23910,0.20422417398578,0.757423672103722,13227,-0.553199498117942,18029,22352,6527,15391,29,18,0.292009663564782,0.688573729420186,8864,-0.396564065855404
IN,Decatur County,18031,2121,8488,11095,0.191167192429022,0.765029292474087,6367,-0.573862100045065,18031,10303,2941,7119,31,18,0.285450839561293,0.690963796952344,4178,-0.405512957391051
IN,DeKalb County,18033,3941,12054,16816,0.23436013320647,0.716817316841104,8113,-0.482457183634634,18033,16314,5419,10586,33,18,0.332168689469168,0.648890523476768,5167,-0.316721834007601
IN,Delaware County,18035,18100,24217,44699,0.404930759077384,0.541779458153426,6117,-0.136848699076042,18035,44924,22630,21231,35,18,0.503739649185291,0.472598165791114,1399,0.031141483394177
IN,Dubois County,18037,5389,13365,19917,0.270572877441382,0.671034794396747,7976,-0.400461916955365,18037,18542,6522,11654,37,18,0.351741991155215,0.628519037859993,5132,-0.276777046704778
IN,Elkhart County,18039,20667,41810,65187,0.317041741451516,0.641385552334054,21143,-0.324343810882538,18039,67768,24376,42348,39,18,0.359697792468422,0.624896706410105,17972,-0.265198913941683
IN,Fayette County,18041,2252,6839,9530,0.236306400839454,0.717628541448059,4587,-0.481322140608604,18041,8816,3553,5044,41,18,0.40301724137931,0.572141560798548,1491,-0.169124319419238
IN,Floyd County,18043,13939,21427,37225,0.374452652787105,0.575607790463398,7488,-0.201155137676293,18043,35283,14805,19868,43,18,0.419607176260522,0.563104044440666,5063,-0.143496868180143
IN,Fountain County,18045,1476,5661,7474,0.197484613326198,0.757425742574257,4185,-0.55994112924806,18045,7103,2233,4660,45,18,0.314374208081092,0.656060819372096,2427,-0.341686611291004
IN,Franklin County,18047,1967,8665,10990,0.178980891719745,0.788444040036397,6698,-0.609463148316651,18047,10549,2907,7421,47,18,0.275571144184283,0.703479002749076,4514,-0.427907858564793
IN,Fulton County,18049,1960,6010,8374,0.234057797946023,0.717697635538572,4050,-0.483639837592548,18049,8120,2621,5315,49,18,0.322783251231527,0.654556650246305,2694,-0.331773399014778
IN,Gibson County,18051,3720,11079,15472,0.240434332988625,0.716067735263702,7359,-0.475633402275078,18051,14718,4928,9487,51,18,0.334828101644245,0.644584862073651,4559,-0.309756760429406
IN,Grant County,18053,7029,17009,25239,0.278497563294901,0.673917350132731,9980,-0.39541978683783,18053,25258,9589,15148,53,18,0.379642093594109,0.59973077836725,5559,-0.220088684773141
IN,Greene County,18055,2929,10275,13763,0.212816973043668,0.746566882220446,7346,-0.533749909176778,18055,13101,4340,8457,55,18,0.331272421952523,0.645523242500572,4117,-0.31425082054805
IN,Hamilton County,18057,57214,87299,153630,0.372414242010024,0.568241879841177,30085,-0.195827637831153,18057,136803,43794,90740,57,18,0.320124558671959,0.663289547743836,46946,-0.343164989071877
IN,Hancock County,18059,8901,25050,36027,0.247064701473895,0.695311849446249,16149,-0.448247147972354,18059,32758,9303,22750,59,18,0.283991696684779,0.694486842908603,13447,-0.410495146223823
IN,Harrison County,18061,4776,12993,18528,0.257772020725389,0.701262953367876,8217,-0.443490932642487,18061,17646,6600,10629,61,18,0.374022441346481,0.602346140768446,4029,-0.228323699421965
IN,Hendricks County,18063,22595,48326,75258,0.300233862180765,0.642137712934173,25731,-0.341903850753408,18063,66590,21100,44308,63,18,0.316864394053161,0.665385192971918,23208,-0.348520798918757
IN,Henry County,18065,5124,13895,20075,0.255242839352428,0.692154420921544,8771,-0.436911581569116,18065,18996,7613,10836,65,18,0.400768582859549,0.570435881238155,3223,-0.169667298378606
IN,Howard County,18067,11215,23675,36754,0.305136855852424,0.644147575774065,12460,-0.339010719921641,18067,36194,15097,20284,67,18,0.417113333701719,0.560424379731447,5187,-0.143311046029729
IN,Huntington County,18069,3506,11649,15974,0.219481657693752,0.729247527231752,8143,-0.509765869537999,18069,15753,4596,10862,69,18,0.291753951628261,0.689519456611439,6266,-0.397765504983178
IN,Jackson County,18071,3843,12857,17532,0.219199178644764,0.733344741044946,9014,-0.514145562400183,18071,16704,5838,10419,71,18,0.349497126436782,0.623742816091954,4581,-0.274245689655172
IN,Jasper County,18073,3329,9382,13331,0.249718700772635,0.703773160303053,6053,-0.454054459530418,18073,12891,4672,7955,73,18,0.362423396167869,0.617097199596618,3283,-0.254673803428749
IN,Jay County,18075,1889,5697,7962,0.237251946747048,0.715523737754333,3808,-0.478271791007285,18075,7897,3063,4643,75,18,0.387868810940864,0.587944789160441,1580,-0.200075978219577
IN,Jefferson County,18077,4325,8538,13461,0.321298566228363,0.634276799643414,4213,-0.312978233415051,18077,13120,5728,7096,77,18,0.436585365853659,0.540853658536585,1368,-0.104268292682927
IN,Jennings County,18079,2364,8222,11115,0.212685560053981,0.739721097615834,5858,-0.527035537561853,18079,10237,3818,6112,79,18,0.372960828367686,0.597049916967862,2294,-0.224089088600176
IN,Johnson County,18081,17318,45456,66229,0.26148665992239,0.686345860574673,28138,-0.424859200652282,18081,57362,17080,39136,81,18,0.297758097695338,0.682263519403089,22056,-0.384505421707751
IN,Knox County,18083,3772,11077,15483,0.243622037072919,0.715429826261061,7305,-0.471807789188142,18083,15145,5228,9612,83,18,0.345196434466821,0.634664905909541,4384,-0.28946847144272
IN,Kosciusko County,18085,6311,23909,31907,0.197793587614003,0.749334001943147,17598,-0.551540414329144,18085,30039,6862,22553,85,18,0.228436366057459,0.75079063883618,15691,-0.522354272778721
IN,LaGrange County,18087,2080,7025,9552,0.217755443886097,0.735448073701842,4945,-0.517692629815745,18087,9311,2897,6227,87,18,0.31113736440769,0.668778863709591,3330,-0.357641499301901
IN,Lake County,18089,116896,75565,200247,0.583759057563909,0.377358961682322,41331,0.206400095881586,18089,201648,130824,68397,89,18,0.648774101404428,0.339190073791954,62427,0.309584027612473
IN,LaPorte County,18091,19795,22678,44994,0.43994754856203,0.504022758590034,2883,-0.064075210028004,18091,43657,24104,18609,91,18,0.552122225530843,0.426254667063701,5495,0.125867558467142
IN,Lawrence County,18093,4210,14034,19076,0.220696162717551,0.735688823652757,9824,-0.514992660935206,18093,17822,5779,11622,93,18,0.324262147907081,0.652115363034452,5843,-0.327853215127371
IN,Madison County,18095,18595,32376,53660,0.346533730898248,0.603354453969437,13781,-0.256820723071189,18095,52340,24404,26755,95,18,0.466259075277035,0.511176920137562,2351,-0.044917844860527
IN,Marion County,18097,212676,130228,361070,0.589015980280832,0.360672445786136,82448,0.228343534494696,18097,357745,215474,136131,97,18,0.602311702469636,0.380525234454709,79343,0.221786468014927
IN,Marshall County,18099,4798,12286,18008,0.266437139049311,0.682252332296757,7488,-0.415815193247446,18099,17751,6136,11260,99,18,0.345670666441327,0.63433046025576,5124,-0.288659793814433
IN,Martin County,18101,881,3695,4807,0.183274391512378,0.768670688579155,2814,-0.585396297066778,18101,4742,1351,3262,101,18,0.284900885702235,0.687895402783636,1911,-0.4029945170814
IN,Miami County,18103,2766,9975,13440,0.205803571428571,0.7421875,7209,-0.536383928571429,18103,12758,4220,8163,103,18,0.330772848408841,0.63983382975388,3943,-0.309060981345038
IN,Monroe County,18105,34183,20527,57623,0.593217985873696,0.356229283445846,13656,0.23698870242785,18105,40200,22885,16254,105,18,0.569278606965174,0.404328358208955,6631,0.164950248756219
IN,Montgomery County,18107,3362,11051,15101,0.222634262631614,0.731805840672803,7689,-0.509171578041189,18107,14349,4244,9768,107,18,0.295769740051572,0.680744302738867,5524,-0.384974562687295
IN,Morgan County,18109,6037,23671,31180,0.19361770365619,0.759172546504169,17634,-0.56555484284798,18109,28251,7969,19591,109,18,0.282078510495204,0.693462178329971,11622,-0.411383667834767
IN,Newton County,18111,1403,4074,5791,0.242272491797617,0.703505439475048,2671,-0.46123294767743,18111,5652,2212,3291,111,18,0.391365888181175,0.582271762208068,1079,-0.190905874026893
IN,Noble County,18113,3904,12198,16890,0.231142687981054,0.722202486678508,8294,-0.491059798697454,18113,16244,5229,10680,113,18,0.321903472051219,0.657473528687515,5451,-0.335570056636296
IN,Ohio County,18115,686,2118,2917,0.235173123071649,0.726088447034625,1432,-0.490915323962976,18115,2812,992,1757,115,18,0.352773826458037,0.624822190611664,765,-0.272048364153627
IN,Orange County,18117,2048,5800,8189,0.25009158627427,0.708267187690805,3752,-0.458175601416534,18117,7753,2939,4615,117,18,0.379079066167935,0.595253450277312,1676,-0.216174384109377
IN,Owen County,18119,1946,6151,8520,0.228403755868545,0.721948356807512,4205,-0.493544600938967,18119,8107,2823,5062,119,18,0.348217589737264,0.624398667817935,2239,-0.276181078080671
IN,Parke County,18121,1441,4863,6576,0.219130170316302,0.739507299270073,3422,-0.520377128953771,18121,6504,2106,4228,121,18,0.32380073800738,0.650061500615006,2122,-0.326260762607626
IN,Perry County,18123,3062,4556,8025,0.381557632398754,0.567725856697819,1494,-0.186168224299065,18123,7866,4314,3403,123,18,0.548436308161709,0.432621408593949,911,0.11581489956776
IN,Pike County,18125,1297,4398,5977,0.216998494227873,0.735820645808934,3101,-0.518822151581061,18125,5924,2125,3627,125,18,0.358710330857529,0.612255232950709,1502,-0.25354490209318
IN,Porter County,18127,33531,38719,76492,0.438359567013544,0.506183653192491,5188,-0.067824086178947,18127,72487,36950,34197,127,18,0.509746575247975,0.471767351387145,2753,0.03797922386083
IN,Posey County,18129,3515,8393,12448,0.282374678663239,0.674244858611825,4878,-0.391870179948586,18129,12216,4531,7427,129,18,0.370907007203667,0.607973149967256,2896,-0.237066142763589
IN,Pulaski County,18131,1327,3854,5437,0.244068420084605,0.708846790509472,2527,-0.464778370424867,18131,5399,1899,3366,131,18,0.35173180218559,0.623448786812373,1467,-0.271716984626783
IN,Putnam County,18133,3356,10637,14680,0.228610354223433,0.724591280653951,7281,-0.495980926430518,18133,13813,4504,9004,133,18,0.326069644537754,0.651849706797944,4500,-0.32578006226019
IN,Randolph County,18135,2446,7515,10456,0.233932670237184,0.718726090283091,5069,-0.484793420045907,18135,10188,3768,6218,135,18,0.369846878680801,0.610325873576757,2450,-0.240478994895956
IN,Ripley County,18137,2471,9806,12790,0.193197810789679,0.766692728694292,7335,-0.573494917904613,18137,10982,3241,7484,137,18,0.295119286104535,0.68147878346385,4243,-0.386359497359315
IN,Rush County,18139,1525,5292,7214,0.21139451067369,0.73357360687552,3767,-0.52217909620183,18139,7026,2221,4633,139,18,0.316111585539425,0.659407913464275,2412,-0.343296327924851
IN,St. Joseph County,18141,52247,52019,109452,0.477350802178124,0.475267697255418,228,0.002083104922706,18141,110644,56458,52575,141,18,0.510267163153899,0.475172625718521,3883,0.035094537435378
IN,Scott County,18143,2642,6074,9060,0.291611479028698,0.670419426048565,3432,-0.378807947019868,18143,8716,3998,4539,143,18,0.458696649839376,0.520766406608536,541,-0.06206975676916
IN,Shelby County,18145,4247,12718,17935,0.236799553944801,0.709116253136326,8471,-0.472316699191525,18145,16743,5357,10972,145,18,0.319954607895837,0.655318640625933,5615,-0.335364032730096
IN,Spencer County,18147,2861,6572,9959,0.287277839140476,0.659905613013355,3711,-0.372627773872879,18147,9725,4026,5515,147,18,0.413984575835476,0.567095115681234,1489,-0.153110539845758
IN,Starke County,18149,2489,6367,9226,0.269781053544331,0.690114892694559,3878,-0.420333839150228,18149,8752,3809,4738,149,18,0.435214808043876,0.54136197440585,929,-0.106147166361974
IN,Steuben County,18151,3741,10127,14530,0.257467309015829,0.696971782518926,6386,-0.439504473503097,18151,13677,4846,8542,151,18,0.354317467280836,0.624552167873072,3696,-0.270234700592235
IN,Sullivan County,18153,2113,6138,8559,0.246874634887253,0.71713985278654,4025,-0.470265217899287,18153,8289,3191,4902,153,18,0.38496802991917,0.591386174448064,1711,-0.206418144528894
IN,Switzerland County,18155,930,2558,3639,0.255564715581204,0.702940368233031,1628,-0.447375652651827,18155,3397,1437,1872,155,18,0.423020312040035,0.55107447748013,435,-0.128054165440094
IN,Tippecanoe County,18157,27207,30711,61916,0.439417921054332,0.49601072420699,3504,-0.056592803152658,18157,56696,26642,28708,157,18,0.469909693805559,0.506349654296599,2066,-0.03643996049104
IN,Tipton County,18159,1587,5589,7510,0.211318242343542,0.744207723035952,4002,-0.53288948069241,18159,7364,2432,4773,159,18,0.330255296034764,0.648153177620858,2341,-0.317897881586094
IN,Union County,18161,715,2445,3286,0.217589774802191,0.744065733414486,1730,-0.526475958612295,18161,3099,1018,2022,161,18,0.328493062278154,0.652468538238141,1004,-0.323975475959987
IN,Vanderburgh County,18163,28296,40422,71957,0.39323484859013,0.56175215753853,12126,-0.1685173089484,18163,72416,31659,39504,163,18,0.437182390631905,0.545514803358374,7845,-0.108332412726469
IN,Vermillion County,18165,2081,4511,6913,0.301027050484594,0.65253869521192,2430,-0.351511644727325,18165,6578,2979,3426,165,18,0.452873213742779,0.520826999087869,447,-0.06795378534509
IN,Vigo County,18167,15922,21924,39569,0.402385705981956,0.554070105385529,6002,-0.151684399403573,18167,39843,19707,19368,167,18,0.494616369249304,0.486107973797154,339,0.00850839545215
IN,Wabash County,18169,3018,9819,13415,0.224972046216921,0.731941856131196,6801,-0.506969809914275,18169,12702,3929,8528,169,18,0.309321366713903,0.671390332231145,4599,-0.362068965517241
IN,Warren County,18171,839,2896,3919,0.214085225822914,0.738964021434039,2057,-0.524878795611125,18171,3798,1324,2377,171,18,0.348604528699315,0.625855713533439,1053,-0.277251184834123
IN,Warrick County,18173,9086,19133,29609,0.306866155560809,0.646188658853727,10047,-0.339322503292918,18173,24627,8791,15350,173,18,0.356965931700979,0.623299630486864,6559,-0.266333698785885
IN,Washington County,18175,2636,8206,11333,0.232595076325774,0.724080120003529,5570,-0.491485043677755,18175,10725,3909,6532,175,18,0.364475524475524,0.609044289044289,2623,-0.244568764568765
IN,Wayne County,18177,8322,16028,25575,0.325395894428152,0.626705767350929,7706,-0.301309872922776,18177,25458,10591,14321,177,18,0.416018540340954,0.562534370335454,3730,-0.146515829994501
IN,Wells County,18179,2585,9999,13123,0.196982397317686,0.761944677284158,7414,-0.564962279966471,18179,12922,3434,9255,179,18,0.265748336170871,0.716220399318991,5821,-0.450472063148119
IN,White County,18181,2563,6813,9902,0.258836598666936,0.688042819632398,4250,-0.429206220965462,18181,9901,3635,5970,181,18,0.367134632865367,0.602969397030603,2335,-0.235834764165236
IN,Whitley County,18183,3379,11357,15535,0.217508850981654,0.731058899259736,7978,-0.513550048278082,18183,15005,4420,10257,183,18,0.294568477174275,0.683572142619127,5837,-0.389003665444852
IA,Adair County,19001,1127,2456,3759,0.299813780260708,0.653365256717212,1329,-0.353551476456504,19001,3959,1788,2110,1,19,0.451629199292751,0.532962869411467,322,-0.081333670118717
IA,Adams County,19003,565,1393,2082,0.271373679154659,0.669068203650336,828,-0.397694524495677,19003,2158,1018,1103,3,19,0.471733086190918,0.51112140871177,85,-0.039388322520853
IA,Allamakee County,19005,2409,4072,6837,0.352347520842475,0.595582857978646,1663,-0.243235337136171,19005,6824,3511,3230,5,19,0.514507620164127,0.473329425556858,281,0.041178194607269
IA,Appanoose County,19007,1813,4031,6096,0.29740813648294,0.661253280839895,2218,-0.363845144356955,19007,6176,2934,3153,7,19,0.475064766839378,0.510524611398964,219,-0.035459844559586
IA,Audubon County,19009,1079,2135,3379,0.319325244155075,0.631843740751702,1056,-0.312518496596626,19009,3439,1608,1800,9,19,0.467577784239605,0.523407967432393,192,-0.055830183192789
IA,Benton County,19011,4672,8226,13690,0.34127100073046,0.600876552227904,3554,-0.259605551497443,19011,13959,6850,6935,11,19,0.490722831148363,0.496812092556773,85,-0.00608926140841
IA,Black Hawk County,19013,32006,27382,63221,0.506255832713813,0.433115578684298,4624,0.073140254029516,19013,66205,39338,26078,13,19,0.594184729250057,0.393897741862397,13260,0.200286987387659
IA,Boone County,19015,5517,7458,13984,0.394522311212815,0.533323798627002,1941,-0.138801487414188,19015,14237,7457,6540,15,19,0.523776076420594,0.459366439558896,917,0.064409636861698
IA,Bremer County,19017,5349,7199,13350,0.400674157303371,0.539250936329588,1850,-0.138576779026217,19017,13218,6710,6383,17,19,0.507641095475866,0.482902103192616,327,0.02473899228325
IA,Buchanan County,19019,3966,5504,10137,0.391240011837822,0.542961428430502,1538,-0.15172141659268,19019,10478,5903,4443,19,19,0.563370872303875,0.424031303683909,1460,0.139339568619966
IA,Buena Vista County,19021,2851,4895,8179,0.348575620491503,0.598483922239883,2044,-0.24990830174838,19021,8322,3683,4548,21,19,0.442561884162461,0.546503244412401,865,-0.10394136024994
IA,Butler County,19023,2163,4918,7457,0.290063028027357,0.659514550087166,2755,-0.36945152205981,19023,7510,3321,4104,23,19,0.442210386151798,0.54647137150466,783,-0.104260985352863
IA,Calhoun County,19025,1396,3466,5105,0.273457394711068,0.678942213516161,2070,-0.405484818805093,19025,5190,2232,2890,25,19,0.430057803468208,0.556840077071291,658,-0.126782273603083
IA,Carroll County,19027,3305,6627,10435,0.316722568279827,0.635074269286057,3322,-0.318351701006229,19027,10581,4912,5577,27,19,0.464228333805879,0.527076835837822,665,-0.062848502031944
IA,Cass County,19029,1946,4755,7055,0.275832742735648,0.673990077958894,2809,-0.398157335223246,19029,7167,2856,4212,29,19,0.398493093344496,0.587693595646714,1356,-0.189200502302218
IA,Cedar County,19031,3578,5275,9386,0.381206051566162,0.56200724483273,1697,-0.180801193266567,19031,9548,4931,4510,31,19,0.51644323418517,0.472350230414747,421,0.044093003770423
IA,Cerro Gordo County,19033,9840,11583,22633,0.434763398577299,0.511774842044802,1743,-0.077011443467503,19033,23548,13204,10084,33,19,0.560727025649737,0.428231696959402,3120,0.132495328690335
IA,Cherokee County,19035,1676,4188,6186,0.270934367927578,0.677012609117362,2512,-0.406078241189783,19035,6367,2623,3656,35,19,0.411967959792681,0.57421077430501,1033,-0.162242814512329
IA,Chickasaw County,19037,2264,3739,6367,0.355583477304853,0.587246741008324,1475,-0.231663263703471,19037,6462,3552,2836,37,19,0.549675023212628,0.438873413803776,716,0.110801609408852
IA,Clarke County,19039,1463,2706,4405,0.332122587968218,0.614301929625426,1243,-0.282179341657208,19039,4398,2187,2124,39,19,0.497271487039563,0.482946793997271,63,0.014324693042292
IA,Clay County,19041,2246,5870,8542,0.262936080543198,0.687192694919223,3624,-0.424256614376024,19041,8400,3363,4934,41,19,0.400357142857143,0.587380952380952,1571,-0.187023809523809
IA,Clayton County,19043,3236,5309,9098,0.355682567597274,0.583534842822598,2073,-0.227852275225324,19043,9035,4768,4146,43,19,0.527725511898174,0.458882125069175,622,0.068843386828998
IA,Clinton County,19045,10079,11249,22748,0.44307191841041,0.494505011429576,1170,-0.051433093019167,19045,24873,15123,9423,45,19,0.608008684115306,0.378844530213484,5700,0.229164153901821
IA,Crawford County,19047,1985,4608,6862,0.289274264062955,0.671524336928009,2623,-0.382250072865054,19047,6686,3035,3584,47,19,0.453933592581514,0.536045468142387,549,-0.082111875560874
IA,Dallas County,19049,15662,19288,37617,0.416354307892708,0.512746896350054,3626,-0.096392588457347,19049,37799,16466,20921,49,19,0.435619989946824,0.553480250800286,4455,-0.117860260853462
IA,Davis County,19051,976,2721,3858,0.252980819077242,0.705287713841369,1745,-0.452306894764126,19051,3738,1518,2133,51,19,0.406099518459069,0.570626003210273,615,-0.164526484751204
IA,Decatur County,19053,1201,2296,3703,0.324331623008372,0.620037807183365,1095,-0.295706184174993,19053,3812,1790,1945,53,19,0.469569779643232,0.510230849947534,155,-0.040661070304302
IA,Delaware County,19055,2956,5688,9165,0.32253136933988,0.620621931260229,2732,-0.298090561920349,19055,9323,4605,4628,55,19,0.493939718974579,0.496406736029175,23,-0.002467017054596
IA,Des Moines County,19057,8178,9479,18713,0.43702239085128,0.506546251269171,1301,-0.069523860417891,19057,20264,11873,8130,57,19,0.585915909988156,0.401204105803395,3743,0.184711804184761
IA,Dickinson County,19059,3051,6743,10247,0.297745681662926,0.658046257441202,3692,-0.360300575778276,19059,10118,4088,5911,59,19,0.404032417473809,0.584206364894248,1823,-0.180173947420439
IA,Dubuque County,19061,22774,23384,49037,0.464424822073129,0.476864408507861,610,-0.012439586434733,19061,50516,28600,21265,61,19,0.566157257106659,0.420955736796263,7335,0.145201520310397
IA,Emmet County,19063,1356,3121,4707,0.288081580624602,0.663055024431698,1765,-0.374973443807096,19063,4646,2087,2499,63,19,0.449203616013775,0.537882049074473,412,-0.088678433060697
IA,Fayette County,19065,3666,5591,9813,0.37358605930908,0.56975440741873,1925,-0.196168348109651,19065,10309,5709,4484,65,19,0.553787952274711,0.434959743913086,1225,0.118828208361626
IA,Floyd County,19067,3177,4371,7985,0.397871008140263,0.547401377582968,1194,-0.149530369442705,19067,8228,4674,3466,67,19,0.568060281964025,0.421244530870199,1208,0.146815751093826
IA,Franklin County,19069,1490,3153,4915,0.303153611393693,0.641505595116989,1663,-0.338351983723296,19069,5133,2256,2818,69,19,0.439509059029807,0.54899668809663,562,-0.109487629066822
IA,Fremont County,19071,959,2401,3554,0.269836803601576,0.6755768148565,1442,-0.405740011254924,19071,3655,1636,1971,71,19,0.447606019151847,0.539261285909713,335,-0.091655266757866
IA,Greene County,19073,1688,2819,4762,0.354472910541789,0.591978160436791,1131,-0.237505249895002,19073,4804,2369,2373,73,19,0.493130724396336,0.493963363863447,4,-0.000832639467111
IA,Grundy County,19075,1847,4516,6766,0.272982559858114,0.667454921667159,2669,-0.394472361809045,19075,6890,2615,4205,75,19,0.379535558780842,0.610304789550073,1590,-0.230769230769231
IA,Guthrie County,19077,1720,3603,5654,0.304209409267775,0.63724796604174,1883,-0.333038556773965,19077,5843,2565,3164,77,19,0.438986821838097,0.541502652746877,599,-0.10251583090878
IA,Hamilton County,19079,2715,4450,7589,0.357754644880748,0.586375016471208,1735,-0.22862037159046,19079,7872,3776,3986,79,19,0.479674796747968,0.50635162601626,210,-0.026676829268293
IA,Hancock County,19081,1582,3972,5815,0.272055030094583,0.683061049011178,2390,-0.411006018916595,19081,5881,2506,3306,81,19,0.426118007141643,0.562149294337698,800,-0.136031287196055
IA,Hardin County,19083,2774,5231,8423,0.32933634097115,0.621037635046895,2457,-0.291701294075745,19083,8775,4021,4647,83,19,0.458233618233618,0.52957264957265,626,-0.071339031339031
IA,Harrison County,19085,2123,4892,7378,0.287747357007319,0.663052317701274,2769,-0.375304960693955,19085,7282,3131,4059,85,19,0.429964295523208,0.557401812688822,928,-0.127437517165614
IA,Henry County,19087,2897,5764,9286,0.311975016153349,0.620719362481154,2867,-0.308744346327805,19087,9613,4451,5025,87,19,0.46301882866951,0.522729636949963,574,-0.059710808280454
IA,Howard County,19089,1674,2611,4507,0.371422232083426,0.579321056134901,937,-0.207898824051475,19089,4625,2767,1793,89,19,0.59827027027027,0.387675675675676,974,0.210594594594595
IA,Humboldt County,19091,1251,3564,5033,0.248559507252136,0.708126365984502,2313,-0.459566858732366,19091,5124,1967,3099,91,19,0.383879781420765,0.60480093676815,1132,-0.220921155347385
IA,Ida County,19093,792,2655,3590,0.220612813370474,0.739554317548747,1863,-0.518941504178273,19093,3626,1317,2276,93,19,0.363210148924435,0.627688913403199,959,-0.264478764478764
IA,Iowa County,19095,3070,5193,8789,0.34930026169075,0.590852201615656,2123,-0.241551939924906,19095,8788,4118,4551,95,19,0.468593536640874,0.517865270823851,433,-0.049271734182977
IA,Jackson County,19097,3837,5821,10204,0.376029008232066,0.57046256370051,1984,-0.194433555468444,19097,10166,5877,4171,97,19,0.578103482195554,0.410289199291757,1706,0.167814282903797
IA,Jasper County,19099,7108,10556,18776,0.378568385172561,0.562207072858969,3448,-0.183638687686408,19099,19385,10240,8868,99,19,0.528243487232396,0.457467113747743,1372,0.070776373484653
IA,Jefferson County,19101,3702,3738,8001,0.462692163479565,0.467191601049869,36,-0.004499437570304,19101,8405,4772,3429,101,19,0.567757287328971,0.407971445568114,1343,0.159785841760857
IA,Johnson County,19103,49942,20993,75637,0.660285310099555,0.277549347541547,28949,0.382735962558007,19103,74928,50090,23556,103,19,0.66850843476404,0.314381806534273,26534,0.354126628229767
IA,Jones County,19105,3779,5718,10011,0.377484766756568,0.57117171111777,1939,-0.193686944361203,19105,10371,5514,4712,105,19,0.531674862597628,0.454343843409507,802,0.077331019188121
IA,Keokuk County,19107,1265,3385,4858,0.26039522437217,0.696788801976122,2120,-0.436393577603952,19107,5221,2298,2840,107,19,0.440145565983528,0.543957096341697,542,-0.103811530358169
IA,Kossuth County,19109,2529,5637,8505,0.297354497354497,0.662786596119929,3108,-0.365432098765432,19109,8833,3824,4914,109,19,0.432921997056493,0.556322880108683,1090,-0.123400883052191
IA,Lee County,19111,6195,8762,15893,0.389794249040458,0.551311898320015,2567,-0.161517649279557,19111,16488,9428,6787,111,19,0.571809801067443,0.411632702571567,2641,0.160177098495876
IA,Linn County,19113,58481,48183,114664,0.510020581873997,0.420210353729156,10298,0.089810228144841,19113,117122,68028,47427,113,19,0.580830245385154,0.404936732637762,20601,0.175893512747392
IA,Louisa County,19115,1643,3060,4943,0.33238923730528,0.619057252680558,1417,-0.286668015375278,19115,4921,2449,2416,115,19,0.497663076610445,0.49095712253607,33,0.006705954074375
IA,Lucas County,19117,1236,2873,4297,0.287642541307889,0.668606004188969,1637,-0.38096346288108,19117,4273,1977,2248,117,19,0.462672595366253,0.526094079101334,271,-0.063421483735081
IA,Lyon County,19119,917,5188,6336,0.144728535353535,0.818813131313131,4271,-0.674084595959596,19119,6466,1416,4965,119,19,0.218991648623569,0.767862666254253,3549,-0.548871017630684
IA,Madison County,19121,2666,5336,8523,0.312800657045641,0.62607063240643,2670,-0.313269975360788,19121,8140,3508,4492,121,19,0.430958230958231,0.551842751842752,984,-0.120884520884521
IA,Mahaska County,19123,2606,7404,10494,0.248332380407852,0.705546026300743,4798,-0.457213645892891,19123,10777,4207,6420,123,19,0.390368377099378,0.595713092697411,2213,-0.205344715598033
IA,Marion County,19125,5469,10940,17554,0.311552922410846,0.623219778967757,5471,-0.31166685655691,19125,17536,7478,9810,125,19,0.42643704379562,0.559420620437956,2332,-0.132983576642336
IA,Marshall County,19127,7623,9125,17700,0.430677966101695,0.515536723163842,1502,-0.084858757062147,19127,18727,10085,8411,127,19,0.53852726010573,0.449137608800128,1674,0.089389651305602
IA,Mills County,19129,2080,5050,7608,0.273396424815983,0.663774973711882,2970,-0.390378548895899,19129,7169,2842,4211,129,19,0.396429069605245,0.587390152043521,1369,-0.190961082438276
IA,Mitchell County,19131,1879,3180,5360,0.350559701492537,0.593283582089552,1301,-0.242723880597015,19131,5580,2831,2643,131,19,0.507347670250896,0.473655913978495,188,0.033691756272402
IA,Monona County,19133,1244,3115,4525,0.274917127071823,0.688397790055249,1871,-0.413480662983425,19133,4707,2098,2555,133,19,0.445719141703845,0.542808582961547,457,-0.097089441257701
IA,Monroe County,19135,1053,2635,3844,0.273933402705515,0.685483870967742,1582,-0.411550468262227,19135,3802,1729,2022,135,19,0.454760652288269,0.531825355076276,293,-0.077064702788006
IA,Montgomery County,19137,1312,3431,4998,0.2625050020008,0.686474589835934,2119,-0.423969587835134,19137,5000,1919,2999,137,19,0.3838,0.5998,1080,-0.216
IA,Muscatine County,19139,8284,9549,19086,0.434035418631458,0.500314366551399,1265,-0.066278947919941,19139,19726,11213,8152,139,19,0.568437595052215,0.413261685085674,3061,0.155175909966542
IA,O'Brien County,19141,1314,5735,7348,0.178824169842134,0.780484485574306,4421,-0.601660315732172,19141,7295,1964,5259,141,19,0.269225496915696,0.720904729266621,3295,-0.451679232350925
IA,Osceola County,19143,552,2528,3197,0.172661870503597,0.790741319987488,1976,-0.618079449483891,19143,3179,909,2225,143,19,0.285938974520289,0.699905630701478,1316,-0.413966656181189
IA,Page County,19145,1801,4875,6968,0.258467278989667,0.699626865671642,3074,-0.441159586681975,19145,7014,2588,4338,145,19,0.368976333048189,0.618477331052181,1750,-0.249500998003992
IA,Palo Alto County,19147,1395,3079,4674,0.298459563543004,0.65875053487377,1684,-0.360290971330766,19147,4857,2124,2649,147,19,0.437306979617048,0.545398394070414,525,-0.108091414453366
IA,Plymouth County,19149,2878,9659,13057,0.220418166500728,0.739756452477598,6781,-0.519338285976871,19149,12909,4148,8577,149,19,0.321326206522581,0.664420171973042,4429,-0.343093965450461
IA,Pocahontas County,19151,962,2692,3831,0.25110937092143,0.702688593056643,1730,-0.451579222135213,19151,3992,1518,2388,151,19,0.380260521042084,0.598196392785571,870,-0.217935871743487
IA,Polk County,19153,119671,93421,228420,0.523907713860433,0.408987829437002,26250,0.114919884423431,19153,227563,128264,96029,153,19,0.563641716799304,0.421988636113955,32235,0.141653080685349
IA,Pottawattamie County,19155,15341,24441,42226,0.363306967271349,0.578814000852555,9100,-0.215507033581206,19155,41679,19347,21751,155,19,0.464190599582524,0.52186952662012,2404,-0.057678927037597
IA,Poweshiek County,19157,4272,4936,9693,0.440730424017332,0.509233467450738,664,-0.068503043433406,19157,9858,5307,4409,157,19,0.538344491783323,0.447250963684317,898,0.091093528099006
IA,Ringgold County,19159,753,1820,2684,0.280551415797317,0.678092399403875,1067,-0.397540983606557,19159,2578,1181,1366,159,19,0.45810705973623,0.529868114817688,185,-0.071761055081459
IA,Sac County,19161,1269,3692,5158,0.246025591314463,0.715781310585498,2423,-0.469755719271035,19161,5256,2117,3086,161,19,0.402777777777778,0.587138508371385,969,-0.184360730593607
IA,Scott County,19163,40302,39083,84878,0.474822686679705,0.460460896816607,1219,0.014361789863098,19163,89826,50581,38223,163,19,0.563099770667735,0.425522677175873,12358,0.137577093491862
IA,Shelby County,19165,1649,4340,6270,0.262998405103668,0.692185007974482,2691,-0.429186602870813,19165,6456,2468,3903,165,19,0.382280049566295,0.604553903345725,1435,-0.22227385377943
IA,Sioux County,19167,2289,14761,17989,0.127244427149925,0.82055700705987,12472,-0.693312579909945,19167,17181,2683,14361,167,19,0.1561608753856,0.835865199930155,11678,-0.679704324544555
IA,Story County,19169,25085,19111,48910,0.512880801472092,0.390738090370067,5974,0.122142711102024,19169,46529,25940,19557,169,19,0.557501773087752,0.420318511036128,6383,0.137183262051624
IA,Tama County,19171,3194,4968,8636,0.369847151459009,0.575266327003242,1774,-0.205419175544233,19171,8930,4737,4076,171,19,0.530459126539754,0.456438969764838,661,0.074020156774916
IA,Taylor County,19173,755,2108,3003,0.251415251415251,0.701964701964702,1353,-0.450549450549451,19173,2978,1261,1680,173,19,0.423438549361988,0.564137004701142,419,-0.140698455339154
IA,Union County,19175,1920,3521,5768,0.332871012482663,0.610436893203883,1601,-0.27756588072122,19175,5899,3029,2800,175,19,0.513476860484828,0.474656721478217,229,0.038820139006611
IA,Van Buren County,19177,843,2524,3526,0.23908111174135,0.715825297787862,1681,-0.476744186046512,19177,3540,1398,2058,177,19,0.394915254237288,0.58135593220339,660,-0.186440677966102
IA,Wapello County,19179,5591,8710,14996,0.37283275540144,0.580821552413977,3119,-0.207988797012537,19179,15630,8616,6777,179,19,0.551247600767754,0.433589251439539,1839,0.117658349328215
IA,Warren County,19181,10371,14773,26916,0.385309852875613,0.548855699212364,4402,-0.163545846336751,19181,25875,12521,13031,181,19,0.483903381642512,0.503613526570048,510,-0.019710144927536
IA,Washington County,19183,3938,6170,10824,0.363821138211382,0.570029563932003,2232,-0.206208425720621,19183,10880,5081,5540,183,19,0.467003676470588,0.509191176470588,459,-0.0421875
IA,Wayne County,19185,719,2069,2921,0.24614857925368,0.708319068812051,1350,-0.46217048955837,19185,2886,1251,1583,185,19,0.433471933471934,0.548510048510048,332,-0.115038115038115
IA,Webster County,19187,6293,10049,17239,0.365044376123905,0.582922443297175,3756,-0.21787806717327,19187,18118,9458,8453,187,19,0.522022298266917,0.466552599624683,1005,0.055469698642234
IA,Winnebago County,19189,1920,3437,5717,0.335840475774007,0.601189435018366,1517,-0.265348959244359,19189,5878,2895,2897,189,19,0.492514460700919,0.492854712487241,2,-0.000340251786322
IA,Winneshiek County,19191,5238,5332,11217,0.466969778015512,0.475349915307123,94,-0.008380137291611,19191,11016,6245,4618,191,19,0.566902687000726,0.419208424110385,1627,0.147694262890341
IA,Woodbury County,19193,16102,24627,42933,0.375049495725899,0.5736147019775,8525,-0.198565206251601,19193,44702,22026,22136,193,19,0.492729631783813,0.495190371795445,110,-0.002460740011633
IA,Worth County,19195,1523,2443,4216,0.361242884250474,0.579459203036053,920,-0.218216318785579,19195,4143,2343,1743,195,19,0.565532223026792,0.42070963070239,600,0.144822592324403
IA,Wright County,19197,1890,3790,5949,0.317700453857791,0.637081862497899,1900,-0.319381408640108,19197,6174,2794,3309,197,19,0.452542921930677,0.535957240038873,515,-0.083414318108196
KS,Allen County,20001,1398,3575,5314,0.263078660143018,0.672751223184042,2177,-0.409672563041024,20001,5221,1842,3261,1,20,0.352805975866692,0.624592989848688,1419,-0.271787013981996
KS,Anderson County,20003,665,2386,3277,0.202929508696979,0.728104974061642,1721,-0.525175465364663,20003,3274,937,2246,3,20,0.286194257788638,0.686010995723885,1309,-0.399816737935247
KS,Atchison County,20005,1946,3977,6393,0.304395432504302,0.622086657281402,2031,-0.3176912247771,20005,6499,2486,3836,5,20,0.382520387751962,0.590244653023542,1350,-0.20772426527158
KS,Barber County,20007,281,1822,2209,0.127206880941603,0.824807605251245,1541,-0.697600724309642,20007,2282,473,1753,7,20,0.207274320771253,0.768185801928133,1280,-0.56091148115688
KS,Barton County,20009,1823,7766,10088,0.180709754163362,0.769825535289453,5943,-0.58911578112609,20009,12010,2693,9132,9,20,0.224229808492923,0.760366361365529,6439,-0.536136552872606
KS,Bourbon County,20011,1306,4314,5918,0.220682663061845,0.7289624873268,3008,-0.508279824264954,20011,6118,1951,4022,11,20,0.318895063746322,0.657404380516509,2071,-0.338509316770186
KS,Brown County,20013,850,2861,3960,0.214646464646465,0.722474747474748,2011,-0.507828282828283,20013,3865,1039,2738,13,20,0.26882276843467,0.708408796895213,1699,-0.439586028460543
KS,Butler County,20015,6489,18781,27051,0.239880226239326,0.694281172599904,12292,-0.454400946360578,20015,25452,7124,17764,15,20,0.27989941851328,0.697941222693698,10640,-0.418041804180418
KS,Chase County,20017,313,964,1342,0.233233979135618,0.71833084947839,651,-0.485096870342772,20017,1233,343,857,17,20,0.278183292781833,0.695052716950527,514,-0.416869424168694
KS,Chautauqua County,20019,236,1552,1845,0.127913279132791,0.841192411924119,1316,-0.713279132791328,20019,1502,259,1201,19,20,0.172436750998668,0.799600532623169,942,-0.627163781624501
KS,Cherokee County,20021,1959,6017,8386,0.233603625089435,0.717505366086334,4058,-0.4839017409969,20021,8396,2868,5345,21,20,0.341591233920915,0.636612672701286,2477,-0.295021438780372
KS,Cheyenne County,20023,188,1172,1409,0.133427963094393,0.831795599716111,984,-0.698367636621718,20023,1422,231,1157,23,20,0.162447257383966,0.813642756680731,926,-0.651195499296765
KS,Clark County,20025,118,813,983,0.120040691759919,0.82706002034588,695,-0.707019328585961,20025,1000,171,791,25,20,0.171,0.791,620,-0.62
KS,Clay County,20027,665,2831,3727,0.178427689830963,0.759592165280386,2166,-0.581164475449423,20027,3584,811,2715,27,20,0.226283482142857,0.757533482142857,1904,-0.53125
KS,Cloud County,20029,744,2856,3831,0.194205168363352,0.745497259201253,2112,-0.551292090837901,20029,3957,951,2886,29,20,0.240333586050038,0.729340409401061,1935,-0.489006823351023
KS,Coffey County,20031,719,2990,3962,0.181474003028773,0.754669358909642,2271,-0.573195355880868,20031,3839,884,2860,31,20,0.230268299036207,0.744985673352435,1976,-0.514717374316228
KS,Comanche County,20033,102,705,857,0.11901983663944,0.822637106184364,603,-0.703617269544924,20033,915,141,756,33,20,0.154098360655738,0.826229508196721,615,-0.672131147540984
KS,Cowley County,20035,3436,8016,12171,0.282310409990962,0.658614739955632,4580,-0.37630432996467,20035,12444,4219,7932,35,20,0.339038894246223,0.6374156219865,3713,-0.298376727740276
KS,Crawford County,20037,5064,8394,14404,0.35156900860872,0.582754790336018,3330,-0.231185781727298,20037,14385,6545,7480,37,20,0.454987834549878,0.519986096628432,935,-0.064998262078554
KS,Decatur County,20039,178,1220,1460,0.121917808219178,0.835616438356164,1042,-0.713698630136986,20039,1533,266,1219,39,20,0.17351598173516,0.795172863666014,953,-0.621656881930855
KS,Dickinson County,20041,1582,5905,8008,0.197552447552448,0.737387612387612,4323,-0.539835164835165,20041,7854,1962,5709,41,20,0.249809014514897,0.726890756302521,3747,-0.477081741787624
KS,Doniphan County,20043,584,2601,3366,0.173499702911468,0.772727272727273,2017,-0.599227569815805,20043,3369,885,2397,43,20,0.262689225289403,0.711487088156723,1512,-0.44879786286732
KS,Douglas County,20045,30089,14308,48231,0.623851879496589,0.296655677883519,15781,0.32719620161307,20045,46283,28012,17028,45,20,0.605233022924184,0.367910463885228,10984,0.237322559038956
KS,Edwards County,20047,208,1033,1308,0.159021406727829,0.789755351681957,825,-0.630733944954129,20047,1365,291,1048,47,20,0.213186813186813,0.767765567765568,757,-0.554578754578755
KS,Elk County,20049,160,1048,1259,0.127084988085782,0.832406671961874,888,-0.705321683876092,20049,1356,277,1040,49,20,0.204277286135693,0.766961651917404,763,-0.562684365781711
KS,Ellis County,20051,2669,8311,11660,0.228902229845626,0.712778730703259,5642,-0.483876500857633,20051,12779,3464,9057,51,20,0.271069723765553,0.708740903044057,5593,-0.437671179278504
KS,Ellsworth County,20053,515,1933,2626,0.196115765422696,0.736100533130236,1418,-0.53998476770754,20053,2677,696,1905,53,20,0.259992528950317,0.711617482256257,1209,-0.45162495330594
KS,Finney County,20055,3006,6155,9731,0.3089096701264,0.632514643921488,3149,-0.323604973795088,20055,7593,2307,5108,55,20,0.303832477281707,0.672724878177269,2801,-0.368892400895562
KS,Ford County,20057,2032,4994,7425,0.273670033670034,0.672592592592593,2962,-0.398922558922559,20057,8082,2468,5459,57,20,0.305369957931205,0.675451620885919,2991,-0.370081662954714
KS,Franklin County,20059,2829,7025,10658,0.265434415462563,0.659129292550197,4196,-0.393694877087634,20059,10806,3611,6893,59,20,0.334166203960762,0.637886359429946,3282,-0.303720155469184
KS,Geary County,20061,2569,4116,7129,0.360359096647496,0.577360078552392,1547,-0.217000981904896,20061,7526,3158,4242,61,20,0.419612011692798,0.563646027106032,1084,-0.144034015413234
KS,Gove County,20063,149,1127,1328,0.112198795180723,0.848644578313253,978,-0.73644578313253,20063,1368,174,1155,63,20,0.12719298245614,0.844298245614035,981,-0.717105263157895
KS,Graham County,20065,185,1013,1265,0.146245059288538,0.800790513833992,828,-0.654545454545455,20065,1319,248,1044,65,20,0.188021228203184,0.791508718726308,796,-0.603487490523124
KS,Grant County,20067,427,1755,2311,0.184768498485504,0.759411510168758,1328,-0.574643011683254,20067,2215,437,1742,67,20,0.197291196388262,0.786455981941309,1305,-0.589164785553047
KS,Gray County,20069,257,1651,2011,0.127797115862755,0.82098458478369,1394,-0.693187468920935,20069,1901,304,1568,69,20,0.159915833771699,0.824829037348764,1264,-0.664913203577065
KS,Greeley County,20071,83,523,639,0.129890453834116,0.818466353677621,440,-0.688575899843506,20071,665,112,539,71,20,0.168421052631579,0.810526315789474,427,-0.642105263157895
KS,Greenwood County,20073,484,2146,2811,0.172180718605478,0.763429384560655,1662,-0.591248665955176,20073,2706,653,1986,73,20,0.241315594974132,0.733924611973392,1333,-0.492609016999261
KS,Hamilton County,20075,114,690,847,0.134592680047225,0.814639905548996,576,-0.680047225501771,20075,857,159,678,75,20,0.185530921820303,0.791131855309218,519,-0.605600933488915
KS,Harper County,20077,388,1950,2513,0.154397134898528,0.775964982093116,1562,-0.621567847194588,20077,2335,536,1723,77,20,0.229550321199144,0.737901498929336,1187,-0.508351177730193
KS,Harvey County,20079,5006,8503,14540,0.344291609353508,0.584800550206327,3497,-0.24050894085282,20079,13805,5162,8352,79,20,0.373922491850779,0.604998189061934,3190,-0.231075697211155
KS,Haskell County,20081,228,1011,1300,0.175384615384615,0.777692307692308,783,-0.602307692307692,20081,1355,202,1131,81,20,0.149077490774908,0.834686346863469,929,-0.685608856088561
KS,Hodgeman County,20083,124,845,1006,0.123260437375746,0.839960238568589,721,-0.716699801192843,20083,1050,178,857,83,20,0.16952380952381,0.816190476190476,679,-0.646666666666667
KS,Jackson County,20085,1489,3888,5727,0.259996507770211,0.678889470927187,2399,-0.418892963156976,20085,5474,1870,3476,85,20,0.341614906832298,0.635001826817684,1606,-0.293386919985385
KS,Jefferson County,20087,2483,5112,8151,0.304625199362041,0.627162311372838,2629,-0.322537112010796,20087,7725,2883,4647,87,20,0.373203883495146,0.601553398058252,1764,-0.228349514563107
KS,Jewell County,20089,180,1204,1483,0.121375590020229,0.811867835468645,1024,-0.690492245448415,20089,1477,225,1220,89,20,0.152335815842925,0.825998645903859,995,-0.673662830060934
KS,Johnson County,20091,126324,133907,279753,0.451555479297809,0.478661533567111,7583,-0.027106054269302,20091,268145,107651,155442,91,20,0.401465624941729,0.579693822372224,47791,-0.178228197430495
KS,Kearny County,20093,224,1048,1325,0.169056603773585,0.790943396226415,824,-0.62188679245283,20093,1341,261,1060,93,20,0.194630872483221,0.790454884414616,799,-0.595824011931394
KS,Kingman County,20095,594,2507,3281,0.181042365132582,0.76409631209997,1913,-0.583053946967388,20095,3199,731,2371,95,20,0.228508909034073,0.741169115348546,1640,-0.512660206314473
KS,Kiowa County,20097,111,855,1023,0.108504398826979,0.835777126099707,744,-0.727272727272727,20097,1133,160,970,97,20,0.141218005295675,0.856134157105031,810,-0.714916151809356
KS,Labette County,20099,2234,5232,7919,0.282106326556383,0.660689480995075,2998,-0.378583154438692,20099,7907,3074,4668,99,20,0.388769444795751,0.590362969520678,1594,-0.201593524724927
KS,Lane County,20101,104,684,831,0.125150421179302,0.823104693140794,580,-0.697954271961492,20101,917,170,732,101,20,0.185387131952017,0.798255179934569,562,-0.612868047982552
KS,Leavenworth County,20103,10064,17387,29676,0.339129262703868,0.585894325380779,7323,-0.246765062676911,20103,28532,11072,16825,103,20,0.388055516612926,0.589688770503295,5753,-0.201633253890369
KS,Lincoln County,20105,214,1168,1448,0.147790055248619,0.806629834254144,954,-0.658839779005525,20105,1459,284,1148,105,20,0.194653872515422,0.786840301576422,864,-0.592186429061001
KS,Linn County,20107,721,3377,4279,0.168497312456181,0.789203084832905,2656,-0.620705772376724,20107,4294,1108,3079,107,20,0.258034466697718,0.717047042384723,1971,-0.459012575687005
KS,Logan County,20109,149,1124,1348,0.11053412462908,0.833827893175074,975,-0.723293768545994,20109,1302,194,1084,109,20,0.14900153609831,0.832565284178187,890,-0.683563748079877
KS,Lyon County,20111,4456,6354,11745,0.379395487441464,0.540996168582375,1898,-0.161600681140911,20111,11614,4972,6358,111,20,0.428104012398829,0.547442741518857,1386,-0.119338729120028
KS,McPherson County,20113,3183,8407,12443,0.255806477537571,0.675640922607088,5224,-0.419834445069517,20113,12060,3384,8399,113,20,0.280597014925373,0.696434494195688,5015,-0.415837479270315
KS,Marion County,20115,1177,3928,5465,0.215370539798719,0.71875571820677,2751,-0.503385178408051,20115,5368,1371,3865,115,20,0.255402384500745,0.720007451564829,2494,-0.464605067064083
KS,Marshall County,20117,1060,3250,4578,0.231542158147663,0.709916994320664,2190,-0.478374836173001,20117,4679,1451,3123,117,20,0.31010899764907,0.667450309895277,1672,-0.357341312246206
KS,Meade County,20119,206,1390,1675,0.122985074626866,0.829850746268657,1184,-0.706865671641791,20119,1648,254,1394,119,20,0.154126213592233,0.845873786407767,1140,-0.691747572815534
KS,Miami County,20121,3949,9839,14712,0.26842033713975,0.668773790103317,5890,-0.400353452963567,20121,14642,4635,9726,121,20,0.31655511542139,0.66425351727906,5091,-0.34769840185767
KS,Mitchell County,20123,469,2216,2824,0.166076487252125,0.784702549575071,1747,-0.618626062322946,20123,2923,576,2293,123,20,0.197057817310982,0.784468012316114,1717,-0.587410195005132
KS,Montgomery County,20125,2557,8466,11623,0.219994837821561,0.728383377785425,5909,-0.508388539963865,20125,12093,3406,8417,125,20,0.281650541635657,0.696022492350947,5011,-0.41437195071529
KS,Morris County,20127,586,1790,2568,0.228193146417445,0.697040498442368,1204,-0.468847352024922,20127,2526,705,1750,127,20,0.279097387173397,0.692794932699921,1045,-0.413697545526524
KS,Morton County,20129,145,970,1160,0.125,0.836206896551724,825,-0.711206896551724,20129,1247,180,1050,129,20,0.144346431435445,0.842020850040096,870,-0.697674418604651
KS,Nemaha County,20131,714,4066,5025,0.142089552238806,0.809154228855721,3352,-0.667064676616915,20131,4959,988,3878,131,20,0.199233716475096,0.782012502520669,2890,-0.582778786045574
KS,Neosho County,20133,1464,4340,6151,0.238010079661844,0.705576329052187,2876,-0.467566249390343,20133,6359,2012,4193,133,20,0.316401949992137,0.65938040572417,2181,-0.342978455732033
KS,Ness County,20135,160,1216,1435,0.111498257839721,0.847386759581882,1056,-0.73588850174216,20135,1417,211,1190,135,20,0.148906139731828,0.839802399435427,979,-0.690896259703599
KS,Norton County,20137,277,1808,2190,0.12648401826484,0.825570776255708,1531,-0.699086757990867,20137,2296,393,1855,137,20,0.17116724738676,0.807926829268293,1462,-0.636759581881533
KS,Osage County,20139,1730,4713,6894,0.250942848854076,0.683637946040035,2983,-0.432695097185959,20139,6771,2228,4336,139,20,0.329050361837247,0.640378083001034,2108,-0.311327721163787
KS,Osborne County,20141,231,1437,1753,0.131774101540217,0.819737592698232,1206,-0.687963491158015,20141,1802,320,1448,141,20,0.177580466148724,0.803551609322974,1128,-0.625971143174251
KS,Ottawa County,20143,424,2261,2866,0.147941381716678,0.788904396371249,1837,-0.640963014654571,20143,2888,548,2260,143,20,0.189750692520776,0.782548476454294,1712,-0.592797783933518
KS,Pawnee County,20145,567,1872,2602,0.217909300538048,0.719446579554189,1305,-0.501537279016141,20145,2565,704,1808,145,20,0.274463937621832,0.704873294346979,1104,-0.430409356725146
KS,Phillips County,20147,296,2200,2611,0.113366526235159,0.842589046342397,1904,-0.729222520107239,20147,2537,376,2116,147,20,0.148206543161214,0.834055971620024,1740,-0.68584942845881
KS,Pottawatomie County,20149,2191,7451,10359,0.211506902210638,0.7192779225794,5260,-0.507771020368762,20149,9303,2291,6692,149,20,0.246264645813179,0.71933784800602,4401,-0.473073202192841
KS,Pratt County,20151,769,2824,3806,0.202049395691014,0.74198633736206,2055,-0.539936941671046,20151,3752,974,2730,151,20,0.259594882729211,0.727611940298508,1756,-0.468017057569296
KS,Rawlins County,20153,160,1209,1448,0.110497237569061,0.834944751381216,1049,-0.724447513812155,20153,1420,184,1207,153,20,0.129577464788732,0.85,1023,-0.720422535211268
KS,Reno County,20155,6670,15100,23448,0.284459228932105,0.643978164448993,8430,-0.359518935516888,20155,23869,7888,15398,155,20,0.330470484729147,0.645104528886841,7510,-0.314634044157694
KS,Republic County,20157,370,1993,2484,0.148953301127214,0.802334943639291,1623,-0.653381642512077,20157,2640,470,2098,157,20,0.178030303030303,0.79469696969697,1628,-0.616666666666667
KS,Rice County,20159,668,2652,3567,0.187272217549762,0.743481917577797,1984,-0.556209700028035,20159,3622,899,2631,159,20,0.248205411374931,0.7263942573164,1732,-0.478188845941469
KS,Riley County,20161,8892,9817,20475,0.434285714285714,0.479462759462759,925,-0.045177045177045,20161,20266,8587,11157,161,20,0.423714595874864,0.55052797789401,2570,-0.126813382019145
KS,Rooks County,20163,273,1999,2378,0.114802354920101,0.840622371740959,1726,-0.725820016820858,20163,2625,398,2159,163,20,0.151619047619048,0.82247619047619,1761,-0.670857142857143
KS,Rush County,20165,227,1177,1474,0.154002713704206,0.798507462686567,950,-0.644504748982361,20165,1549,361,1151,165,20,0.233053582956746,0.743060038734668,790,-0.510006455777921
KS,Russell County,20167,454,2544,3148,0.144218551461245,0.808132147395172,2090,-0.663913595933926,20167,3140,584,2505,167,20,0.185987261146497,0.797770700636943,1921,-0.611783439490446
KS,Saline County,20169,6084,13367,21206,0.286899933980949,0.630340469678393,7283,-0.343440535697444,20169,21102,6910,13697,169,20,0.327457113069851,0.649085394749313,6787,-0.321628281679462
KS,Scott County,20171,232,1832,2159,0.107457156090783,0.848540991199629,1600,-0.741083835108847,20171,2019,271,1702,171,20,0.134224863793957,0.842991579990094,1431,-0.708766716196137
KS,Sedgwick County,20173,66716,101319,180750,0.369106500691563,0.560547717842324,34603,-0.191441217150761,20173,177852,69373,104411,173,20,0.390060274835256,0.587066774621596,35038,-0.197006499786339
KS,Seward County,20175,1491,3025,4743,0.314358001265022,0.637781994518237,1534,-0.323423993253215,20175,4955,1393,3495,175,20,0.281130171543895,0.705348133198789,2102,-0.424217961654894
KS,Shawnee County,20177,33270,35349,73648,0.451743428199001,0.479972300673474,2079,-0.028228872474473,20177,74844,35959,37226,177,20,0.480452674897119,0.497381219603442,1267,-0.016928544706323
KS,Sheridan County,20179,126,1186,1362,0.092511013215859,0.870778267254038,1060,-0.778267254038179,20179,1320,165,1136,179,20,0.125,0.860606060606061,971,-0.735606060606061
KS,Sherman County,20181,340,2043,2537,0.134016554986204,0.805281828931809,1703,-0.671265273945605,20181,2606,575,1967,181,20,0.220644666155027,0.754796623177283,1392,-0.534151957022256
KS,Smith County,20183,295,1635,2014,0.146474677259186,0.811817279046673,1340,-0.665342601787488,20183,1983,345,1598,183,20,0.173978819969743,0.805849722642461,1253,-0.631870902672718
KS,Stafford County,20185,303,1485,1884,0.160828025477707,0.788216560509554,1182,-0.627388535031847,20185,1833,403,1382,185,20,0.219858156028369,0.753955264593562,979,-0.534097108565194
KS,Stanton County,20187,132,580,742,0.177897574123989,0.78167115902965,448,-0.60377358490566,20187,713,135,571,187,20,0.189340813464236,0.800841514726508,436,-0.611500701262272
KS,Stevens County,20189,215,1564,1853,0.116028062601187,0.844036697247706,1349,-0.728008634646519,20189,1998,241,1724,189,20,0.120620620620621,0.862862862862863,1483,-0.742242242242242
KS,Sumner County,20191,2039,6844,9494,0.214767221402991,0.720876342953444,4805,-0.506109121550453,20191,8989,2617,6162,191,20,0.291133607742797,0.68550450550673,3545,-0.394370897763934
KS,Thomas County,20193,467,2832,3483,0.134079816250359,0.813092161929371,2365,-0.679012345679012,20193,3388,576,2729,193,20,0.170011806375443,0.805489964580874,2153,-0.635478158205431
KS,Trego County,20195,193,1211,1459,0.132282385195339,0.830020562028787,1018,-0.697738176833447,20195,1544,289,1230,195,20,0.187176165803109,0.796632124352332,941,-0.609455958549223
KS,Wabaunsee County,20197,773,2358,3340,0.231437125748503,0.705988023952096,1585,-0.474550898203593,20197,3229,908,2230,197,20,0.281201610405698,0.690616289873026,1322,-0.409414679467327
KS,Wallace County,20199,45,711,779,0.057766367137356,0.912708600770218,666,-0.854942233632863,20199,781,68,702,199,20,0.087067861715749,0.898847631241997,634,-0.811779769526248
KS,Washington County,20201,378,2136,2677,0.141202838998879,0.797908106088905,1758,-0.656705267090026,20201,2863,515,2300,201,20,0.179881243450926,0.803353126091512,1785,-0.623471882640587
KS,Wichita County,20203,139,765,934,0.148822269807281,0.819057815845824,626,-0.670235546038544,20203,987,157,821,203,20,0.159067882472138,0.831813576494428,664,-0.67274569402229
KS,Wilson County,20205,550,2747,3482,0.157955198161976,0.788914417001723,2197,-0.630959218839747,20205,3699,813,2812,205,20,0.219789132197891,0.760205460935388,1999,-0.540416328737497
KS,Woodson County,20207,270,1063,1420,0.190140845070423,0.748591549295775,793,-0.558450704225352,20207,1435,377,1030,207,20,0.262717770034843,0.717770034843206,653,-0.455052264808362
KS,Wyandotte County,20209,29346,15520,47467,0.618240040449154,0.326963996039354,13826,0.2912760444098,20209,49422,33265,15273,209,20,0.673080814212294,0.309032414714095,17992,0.364048399498199
KY,Adair County,21001,1323,6637,8228,0.16079241614001,0.806635877491492,5314,-0.645843461351483,21001,7600,1660,5841,1,21,0.218421052631579,0.768552631578947,4181,-0.550131578947368
KY,Allen County,21003,1349,6466,8085,0.166852195423624,0.799752628324057,5117,-0.632900432900433,21003,7099,1808,5184,3,21,0.254683758275813,0.730243696295253,3376,-0.475559938019439
KY,Anderson County,21005,2634,8242,11414,0.230769230769231,0.722095671981777,5608,-0.491326441212546,21005,10318,3315,6822,5,21,0.321283194417523,0.661174646249273,3507,-0.33989145183175
KY,Ballard County,21007,816,3161,4097,0.199170124481328,0.771540151330242,2345,-0.572370026848914,21007,3895,1189,2647,7,21,0.305263157894737,0.679589216944801,1458,-0.374326059050064
KY,Barren County,21009,4275,13483,18473,0.231418827477941,0.729876035294754,9208,-0.498457207816814,21009,16565,5400,10922,9,21,0.325988530033203,0.659341986115303,5522,-0.333353456082101
KY,Bath County,21011,1361,3082,4577,0.297356346952152,0.673366834170854,1721,-0.376010487218702,21011,4122,1770,2275,11,21,0.429403202328967,0.551916545366327,505,-0.122513343037361
KY,Bell County,21013,1720,7764,9714,0.177064031295038,0.799258801729463,6044,-0.622194770434424,21013,9482,2224,7127,13,21,0.234549673064754,0.751634676228644,4903,-0.51708500316389
KY,Boone County,21015,15026,39082,57550,0.261094700260643,0.679096437880104,24056,-0.418001737619461,21015,52495,15628,35920,15,21,0.297704543289837,0.684255643394609,20292,-0.386551100104772
KY,Bourbon County,21017,2791,5569,8791,0.317483790240018,0.63348879535889,2778,-0.316005005118872,21017,7909,3075,4692,17,21,0.388797572385889,0.593248198255152,1617,-0.204450625869263
KY,Boyd County,21019,6021,13591,20443,0.294526243702001,0.664824145184171,7570,-0.37029790148217,21019,19040,7776,10883,19,21,0.408403361344538,0.571586134453781,3107,-0.163182773109244
KY,Boyle County,21021,4281,8040,12928,0.331141707920792,0.621905940594059,3759,-0.290764232673267,21021,12368,4471,7703,21,21,0.361497412677878,0.622816946959897,3232,-0.261319534282018
KY,Bracken County,21023,705,2711,3522,0.200170357751278,0.769733106189665,2006,-0.569562748438387,21023,3230,1147,2029,23,21,0.355108359133127,0.628173374613003,882,-0.273065015479876
KY,Breathitt County,21025,1537,3991,5728,0.268331005586592,0.696752793296089,2454,-0.428421787709497,21025,5008,1562,3318,25,21,0.311900958466454,0.662539936102236,1756,-0.350638977635783
KY,Breckinridge County,21027,1960,6484,8765,0.223616657159156,0.739760410724472,4524,-0.516143753565317,21027,7967,2825,5025,27,21,0.354587674155893,0.630726747834819,2200,-0.276139073678926
KY,Bullitt County,21029,8255,26210,36036,0.229076479076479,0.727328227328227,17955,-0.498251748251748,21029,31775,9971,21306,29,21,0.313800157356412,0.670527143981117,11335,-0.356726986624705
KY,Butler County,21031,947,4428,5575,0.169865470852018,0.794260089686099,3481,-0.624394618834081,21031,5058,1293,3716,31,21,0.255634638196916,0.734677738236457,2423,-0.479043100039541
KY,Caldwell County,21033,1260,4507,5972,0.21098459477562,0.754688546550569,3247,-0.54370395177495,21033,5860,1852,3904,33,21,0.316040955631399,0.666211604095563,2052,-0.350170648464164
KY,Calloway County,21035,4749,10367,16039,0.296090778726853,0.646361992642933,5618,-0.35027121391608,21035,15064,5314,9438,35,21,0.352761550716941,0.626526818906001,4124,-0.27376526818906
KY,Campbell County,21037,14658,25050,42471,0.345129617856891,0.589814226177862,10392,-0.244684608320972,21037,40173,15080,24240,37,21,0.37537649665198,0.603390336793369,9160,-0.228013840141389
KY,Carlisle County,21039,432,2094,2599,0.166217776067718,0.805694497883801,1662,-0.639476721816083,21039,2619,750,1835,39,21,0.286368843069874,0.700649102710958,1085,-0.414280259641084
KY,Carroll County,21041,1106,2588,3851,0.287198130355752,0.672033238119969,1482,-0.384835107764217,21041,3680,1629,1999,41,21,0.442663043478261,0.54320652173913,370,-0.10054347826087
KY,Carter County,21043,2276,7587,10267,0.221681114249537,0.738969513976819,5311,-0.517288399727282,21043,8906,3383,5279,43,21,0.379856276667415,0.592746463058612,1896,-0.212890186391197
KY,Casey County,21045,767,5482,6438,0.119136377757067,0.851506679092886,4715,-0.732370301335819,21045,6091,1086,4904,45,21,0.178295846330652,0.805122311607289,3818,-0.626826465276638
KY,Christian County,21047,7188,14108,22069,0.32570574108478,0.639267751144139,6920,-0.313562010059359,21047,21953,8252,13475,47,21,0.375893955268073,0.613811324192593,5223,-0.237917368924521
KY,Clark County,21049,4706,10710,16193,0.290619403445933,0.661396899895016,6004,-0.370777496449083,21049,15410,5228,9931,49,21,0.339260220635951,0.64445165476963,4703,-0.305191434133679
KY,Clay County,21051,752,5861,6762,0.111209701271813,0.866755397811298,5109,-0.755545696539485,21051,7383,1111,6176,51,21,0.150480834349181,0.836516321278613,5065,-0.686035486929432
KY,Clinton County,21053,547,3809,4454,0.122810956443646,0.8551863493489,3262,-0.732375392905254,21053,4393,752,3569,53,21,0.171181424994309,0.81242886410198,2817,-0.641247439107671
KY,Crittenden County,21055,617,3290,4036,0.152874132804757,0.815163528245788,2673,-0.662289395441031,21055,3854,960,2839,55,21,0.249091852620654,0.736637259989621,1879,-0.487545407368967
KY,Cumberland County,21057,459,2502,3061,0.149950996406403,0.817379941195688,2043,-0.667428944789284,21057,2853,599,2216,57,21,0.209954433929197,0.776726253066947,1617,-0.56677181913775
KY,Daviess County,21059,14163,28907,45752,0.309560237803812,0.631819374016436,14744,-0.322259136212624,21059,42079,16208,25092,59,21,0.385180256184795,0.596306946457853,8884,-0.211126690273058
KY,Edmonson County,21061,979,4135,5239,0.186867722847872,0.789272761977476,3156,-0.602405039129605,21061,4664,1374,3232,61,21,0.294596912521441,0.692967409948542,1858,-0.398370497427101
KY,Elliott County,21063,740,2000,2847,0.25992272567615,0.702493853178785,1260,-0.442571127502634,21063,2399,1186,1126,63,21,0.49437265527303,0.469362234264277,60,0.025010421008754
KY,Estill County,21065,1108,4236,5538,0.200072228241242,0.76489707475623,3128,-0.564824846514987,21065,5184,1356,3749,65,21,0.261574074074074,0.723186728395062,2393,-0.461612654320988
KY,Fayette County,21067,69776,56890,136112,0.512636652168802,0.417964617373927,12886,0.094672034794875,21067,125821,62078,60793,67,21,0.493383457451459,0.483170535920077,1285,0.010212921531382
KY,Fleming County,21069,1348,4722,6250,0.21568,0.75552,3374,-0.53984,21069,5782,1911,3780,69,21,0.330508474576271,0.653753026634383,1869,-0.323244552058111
KY,Floyd County,21071,4015,11993,16521,0.243024030022396,0.725924580836511,7978,-0.482900550814115,21071,14890,4733,9784,71,21,0.317864338482203,0.657085292142377,5051,-0.339220953660175
KY,Franklin County,21073,10717,11819,23840,0.449538590604027,0.495763422818792,1102,-0.046224832214765,21073,23337,11535,11345,73,21,0.494279470368942,0.486137892616874,190,0.008141577752068
KY,Fulton County,21075,774,1549,2381,0.325073498530029,0.650566988660227,775,-0.325493490130197,21075,2481,1022,1425,75,21,0.411930673115679,0.574365175332527,403,-0.162434502216848
KY,Gallatin County,21077,749,2443,3334,0.224655068986203,0.732753449310138,1694,-0.508098380323935,21077,3060,1238,1758,77,21,0.404575163398693,0.574509803921569,520,-0.169934640522876
KY,Garrard County,21079,1453,5904,7613,0.190857743333771,0.7755155654801,4451,-0.584657822146329,21079,7077,1661,5310,79,21,0.234703970609015,0.750317931326833,3649,-0.515613960717818
KY,Grant County,21081,1910,7268,9551,0.199979059784316,0.760967437964611,5358,-0.560988378180295,21081,8606,2810,5664,81,21,0.326516383918197,0.658145479897746,2854,-0.331629095979549
KY,Graves County,21083,3308,12671,16582,0.199493426607164,0.764141840549994,9363,-0.56464841394283,21083,15493,4547,10699,83,21,0.293487381398051,0.690569934809269,6152,-0.397082553411218
KY,Grayson County,21085,1959,8219,10564,0.18544112078758,0.778019689511549,6260,-0.592578568723968,21085,9269,2744,6404,85,21,0.296040565325278,0.690905167763513,3660,-0.394864602438235
KY,Green County,21087,832,4372,5331,0.156068279872444,0.82010879759895,3540,-0.664040517726505,21087,4856,1165,3634,87,21,0.239909390444811,0.74835255354201,2469,-0.508443163097199
KY,Greenup County,21089,4146,11546,16265,0.254903166308023,0.709867814325238,7400,-0.454964648017215,21089,15159,6027,8855,89,21,0.397585592717198,0.584141434131539,2828,-0.186555841414341
KY,Hancock County,21091,1244,2788,4292,0.289841565703635,0.649580615097857,1544,-0.359739049394222,21091,4133,1833,2212,91,21,0.443503508347447,0.535204451971933,379,-0.091700943624486
KY,Hardin County,21093,13944,26970,43113,0.323429128105212,0.625565374712964,13026,-0.302136246607752,21093,39212,15214,23357,93,21,0.38799347138631,0.595659491992247,8143,-0.207666020605937
KY,Harlan County,21095,1372,9129,10744,0.127699180938198,0.849683544303797,7757,-0.721984363365599,21095,10658,1830,8653,95,21,0.171702007881404,0.811878401200976,6823,-0.640176393319572
KY,Harrison County,21097,2031,5435,7774,0.261255466941086,0.699125289426293,3404,-0.437869822485207,21097,7163,2471,4556,97,21,0.344967192517102,0.636046349294988,2085,-0.291079156777886
KY,Hart County,21099,1730,5320,7261,0.23825919294863,0.732681448836248,3590,-0.494422255887619,21099,6621,2283,4256,99,21,0.344811961939284,0.642803201933243,1973,-0.297991239993959
KY,Henderson County,21101,6707,12159,19692,0.340595165549462,0.61745886654479,5452,-0.276863700995328,21101,18614,8091,10296,101,21,0.434672826904481,0.5531320511443,2205,-0.118459224239819
KY,Henry County,21103,1828,4944,7142,0.25595071408569,0.6922430691683,3116,-0.43629235508261,21103,6584,2529,3940,103,21,0.384113001215067,0.598420413122722,1411,-0.214307411907655
KY,Hickman County,21105,449,1657,2157,0.208159480760315,0.768196569309226,1208,-0.56003708854891,21105,2139,686,1431,105,21,0.320710612435718,0.669004207573632,745,-0.348293595137915
KY,Hopkins County,21107,4310,15277,20325,0.212054120541205,0.751635916359164,10967,-0.539581795817958,21107,19765,5789,13681,107,21,0.292891474829244,0.692183152036428,7892,-0.399291677207184
KY,Jackson County,21109,482,4889,5497,0.087684191377115,0.889394215026378,4407,-0.801710023649263,21109,5061,612,4365,109,21,0.120924718435092,0.862477771191464,3753,-0.741553052756372
KY,Jefferson County,21111,190824,143758,352778,0.540918084461049,0.407502735431348,47066,0.133415349029701,21111,339500,186164,148415,111,21,0.548347569955817,0.437157584683358,37749,0.11118998527246
KY,Jessamine County,21113,6144,15474,23292,0.263781555899021,0.664348274085523,9330,-0.400566718186502,21113,20620,6001,14232,113,21,0.291028128031038,0.690203685741998,8231,-0.39917555771096
KY,Johnson County,21115,1250,8043,9560,0.130753138075314,0.841317991631799,6793,-0.710564853556485,21115,9035,1723,7095,115,21,0.190702822357499,0.785279468732706,5372,-0.594576646375208
KY,Kenton County,21117,24213,42958,71905,0.336735971072943,0.597427160837216,18745,-0.260691189764272,21117,67679,24917,41387,117,21,0.368164423233204,0.611519082728764,16470,-0.24335465949556
KY,Knott County,21119,1245,4357,5756,0.216296038915914,0.756949270326616,3112,-0.540653231410702,21119,5693,1420,4130,119,21,0.249429123484982,0.725452309854207,2710,-0.476023186369225
KY,Knox County,21121,1761,9885,12001,0.146737771852346,0.823681359886676,8124,-0.67694358803433,21121,11100,2484,8467,121,21,0.223783783783784,0.762792792792793,5983,-0.539009009009009
KY,Larue County,21123,1278,4799,6359,0.200974996068564,0.754678408554804,3521,-0.55370341248624,21123,5764,1733,3911,123,21,0.300659264399722,0.67852185981957,2178,-0.377862595419847
KY,Laurel County,21125,3440,20592,24811,0.138648180242634,0.829954455684978,17152,-0.691306275442344,21125,22408,3905,18151,125,21,0.174268118529097,0.810023205997858,14246,-0.635755087468761
KY,Lawrence County,21127,1045,4816,6037,0.173099221467616,0.797747225443101,3771,-0.624648003975485,21127,5592,1520,3995,127,21,0.271816881258941,0.714413447782546,2475,-0.442596566523605
KY,Lee County,21129,444,2151,2663,0.166729252722493,0.807735636500188,1707,-0.641006383777694,21129,2623,595,1977,129,21,0.226839496759436,0.753717117804041,1382,-0.526877621044605
KY,Leslie County,21131,400,4015,4487,0.089146422999777,0.894807220860263,3615,-0.805660797860486,21131,4950,433,4439,131,21,0.087474747474748,0.896767676767677,4006,-0.809292929292929
KY,Letcher County,21133,1542,7293,9131,0.168875260102946,0.798707699047202,5751,-0.629832438944256,21133,8758,1702,6811,133,21,0.194336606531171,0.777688970084494,5109,-0.583352363553323
KY,Lewis County,21135,785,4363,5293,0.148309087474022,0.8242962403174,3578,-0.675987152843378,21135,4769,1342,3326,135,21,0.281400712937723,0.697420842944013,1984,-0.416020130006291
KY,Lincoln County,21137,1865,7338,9555,0.195185766614338,0.767974882260597,5473,-0.572789115646258,21137,9152,2582,6416,137,21,0.282124125874126,0.701048951048951,3834,-0.418924825174825
KY,Livingston County,21139,887,3570,4642,0.191081430417923,0.769065058164584,2683,-0.577983627746661,21139,4511,1346,3089,139,21,0.298381733540235,0.684770560851253,1743,-0.386388827311018
KY,Logan County,21141,2755,7778,10896,0.252845080763583,0.713839941262849,5023,-0.460994860499266,21141,10509,3469,6899,141,21,0.330098011228471,0.656484917689599,3430,-0.326386906461129
KY,Lyon County,21143,1045,2789,3959,0.263955544329376,0.704470825966153,1744,-0.440515281636777,21143,3838,1373,2412,143,21,0.357738405419489,0.628452318916102,1039,-0.270713913496613
KY,McCracken County,21145,9134,20774,31284,0.291970336274134,0.664045518475898,11640,-0.372075182201764,21145,30540,10062,19979,145,21,0.329469548133595,0.654191224623445,9917,-0.324721676489849
KY,McCreary County,21147,664,5012,5772,0.115038115038115,0.868329868329868,4348,-0.753291753291753,21147,5704,1069,4564,147,21,0.187412342215989,0.800140252454418,3495,-0.612727910238429
KY,McLean County,21149,988,3381,4565,0.216429353778751,0.740635268346112,2393,-0.52420591456736,21149,4200,1432,2705,149,21,0.340952380952381,0.644047619047619,1273,-0.303095238095238
KY,Madison County,21151,11793,23431,37318,0.316013719920682,0.627873948228737,11638,-0.311860228308055,21151,33317,11512,21128,151,21,0.345529309361587,0.634150733859591,9616,-0.288621424498004
KY,Magoffin County,21153,1172,3824,5113,0.229219636221396,0.747897516135341,2652,-0.518677879913945,21153,4905,1433,3391,153,21,0.292150866462793,0.691335372069317,1958,-0.399184505606524
KY,Marion County,21155,2679,5122,8108,0.330414405525407,0.631721756290084,2443,-0.301307350764677,21155,7316,3418,3800,155,21,0.467195188627665,0.519409513395298,382,-0.052214324767633
KY,Marshall County,21157,3672,12322,16678,0.220170284206739,0.73881760402926,8650,-0.518647319822521,21157,15714,5022,10402,157,21,0.319587628865979,0.661957490136184,5380,-0.342369861270205
KY,Martin County,21159,363,3503,3951,0.091875474563402,0.886610984560871,3140,-0.794735509997469,21159,3824,574,3180,159,21,0.15010460251046,0.831589958158996,2606,-0.681485355648536
KY,Mason County,21161,1970,4944,7212,0.273155851358846,0.685524126455907,2974,-0.41236827509706,21161,6879,2592,4197,161,21,0.376798953336241,0.610117749672918,1605,-0.233318796336677
KY,Meade County,21163,3026,8660,12223,0.247566063977747,0.70850036815839,5634,-0.460934304180643,21163,10915,4122,6606,163,21,0.377645442052222,0.605222171323866,2484,-0.227576729271644
KY,Menifee County,21165,700,2010,2779,0.251889168765743,0.723281756027348,1310,-0.471392587261605,21165,2598,1048,1484,165,21,0.403387220939184,0.571208622016936,436,-0.167821401077752
KY,Mercer County,21167,2395,7740,10579,0.226391908497968,0.731638151053975,5345,-0.505246242556007,21167,9936,2966,6820,167,21,0.298510466988728,0.686392914653784,3854,-0.387882447665056
KY,Metcalfe County,21169,976,3491,4616,0.211438474870017,0.756282495667244,2515,-0.544844020797227,21169,4184,1425,2676,169,21,0.340583173996176,0.639579349904398,1251,-0.298996175908222
KY,Monroe County,21171,601,4278,4991,0.120416750150271,0.857142857142857,3677,-0.736726106992587,21171,4746,936,3762,171,21,0.197218710493047,0.792667509481669,2826,-0.595448798988622
KY,Montgomery County,21173,3158,7856,11437,0.276121360496634,0.686893416105622,4698,-0.410772055608989,21173,10248,3701,6398,173,21,0.361143637782982,0.62431693989071,2697,-0.263173302107728
KY,Morgan County,21175,1006,3628,4766,0.211078472513638,0.761225346202266,2622,-0.550146873688628,21175,4472,1369,3021,175,21,0.306127012522361,0.675536672629696,1652,-0.369409660107334
KY,Muhlenberg County,21177,3272,9393,13046,0.25080484439675,0.719990801778323,6121,-0.469185957381573,21177,12737,4771,7762,177,21,0.37457800109916,0.60940566852477,2991,-0.23482766742561
KY,Nelson County,21179,6434,13430,20761,0.309908000578007,0.64688598815086,6996,-0.336977987572853,21179,18532,7611,10673,179,21,0.410695014029786,0.575922728253831,3062,-0.165227714224045
KY,Nicholas County,21181,787,1957,2837,0.277405710257314,0.689813182939725,1170,-0.412407472682411,21181,2580,948,1583,181,21,0.367441860465116,0.613565891472868,635,-0.246124031007752
KY,Ohio County,21183,2080,7942,10398,0.200038468936334,0.76380073090979,5862,-0.563762261973456,21183,9646,2987,6470,183,21,0.30966203607713,0.670744349989633,3483,-0.361082313912503
KY,Oldham County,21185,10268,20469,32838,0.31268652171265,0.623332724282843,10201,-0.310646202570193,21185,29873,9240,20179,185,21,0.309309409834968,0.675492920028119,10939,-0.366183510193151
KY,Owen County,21187,1062,3745,4997,0.212527516509906,0.749449669801881,2683,-0.536922153291975,21187,4555,1501,2971,187,21,0.329527991218441,0.65225027442371,1470,-0.322722283205269
KY,Owsley County,21189,256,1474,1757,0.145702902675014,0.83892999430848,1218,-0.693227091633466,21189,1580,283,1279,189,21,0.179113924050633,0.809493670886076,996,-0.630379746835443
KY,Pendleton County,21191,1164,4604,6006,0.193806193806194,0.766566766566767,3440,-0.572760572760573,21191,5534,1859,3556,191,21,0.335923382724973,0.642573183953741,1697,-0.306649801228768
KY,Perry County,21193,2136,8158,10566,0.202157864849517,0.772099186068522,6022,-0.569941321219004,21193,10240,2047,8040,193,21,0.19990234375,0.78515625,5993,-0.58525390625
KY,Pike County,21195,4277,19740,24637,0.173600681901206,0.801233916467102,15463,-0.627633234565897,21195,23632,5645,17589,195,21,0.238871022342586,0.74428740690589,11944,-0.505416384563304
KY,Powell County,21197,1272,3513,4952,0.25686591276252,0.709410339256866,2241,-0.452544426494346,21197,4441,1620,2726,197,21,0.364782706597613,0.61382571492907,1106,-0.249043008331457
KY,Pulaski County,21199,4208,22900,28015,0.150205247189006,0.817419239693021,18692,-0.667213992504016,21199,26003,4976,20714,199,21,0.191362535092105,0.796600392262431,15738,-0.605237857170327
KY,Robertson County,21201,222,759,1013,0.219151036525173,0.749259624876604,537,-0.530108588351431,21201,935,340,579,201,21,0.363636363636364,0.619251336898396,239,-0.255614973262032
KY,Rockcastle County,21203,915,5609,6686,0.136853125934789,0.83891714029315,4694,-0.702064014358361,21203,6216,1097,5028,203,21,0.176480051480051,0.808880308880309,3931,-0.632400257400257
KY,Rowan County,21205,3295,5174,8829,0.373201948125495,0.586023332200702,1879,-0.212821384075207,21205,7641,3438,4035,205,21,0.449941107184923,0.528072241853161,597,-0.078131134668237
KY,Russell County,21207,1093,6863,8171,0.133765756945294,0.839921674213683,5770,-0.706155917268388,21207,7907,1445,6346,207,21,0.182749462501581,0.802579992411787,4901,-0.619830529910206
KY,Scott County,21209,7713,15052,24159,0.319259903141686,0.623039033072561,7339,-0.303779129930875,21209,20565,7532,12679,209,21,0.366253343058595,0.616532944322879,5147,-0.250279601264284
KY,Shelby County,21211,6276,13196,20563,0.305208383990663,0.641735155376161,6920,-0.336526771385498,21211,18659,6634,11790,211,21,0.355538882040838,0.631866659520875,5156,-0.276327777480036
KY,Simpson County,21213,2144,5077,7524,0.284954811270601,0.674774056353004,2933,-0.389819245082403,21213,7089,2650,4355,213,21,0.373818592185075,0.614332063760756,1705,-0.240513471575681
KY,Spencer County,21215,1921,7196,9509,0.20201913976233,0.756756756756757,5275,-0.554737616994426,21215,8431,2549,5726,215,21,0.30233661487368,0.67916024196418,3177,-0.376823627090499
KY,Taylor County,21217,2553,8320,11301,0.225909211574197,0.736218033802318,5767,-0.510308822228121,21217,10946,3284,7551,217,21,0.300018271514709,0.689841037822035,4267,-0.389822766307327
KY,Todd County,21219,1042,3612,4771,0.218402850555439,0.757073988681618,2570,-0.538671138126179,21219,4718,1403,3247,219,21,0.297371767698177,0.688215345485375,1844,-0.390843577787198
KY,Trigg County,21221,1587,4928,6740,0.235459940652819,0.731157270029674,3341,-0.495697329376855,21221,6740,2115,4520,221,21,0.31379821958457,0.670623145400593,2405,-0.356824925816024
KY,Trimble County,21223,879,2771,3786,0.232171156893819,0.731907025884839,1892,-0.49973586899102,21223,3540,1355,2133,223,21,0.382768361581921,0.602542372881356,778,-0.219774011299435
KY,Union County,21225,1331,4701,6209,0.214366242551135,0.757126751489773,3370,-0.542760508938637,21225,5975,1941,3952,225,21,0.324853556485356,0.661422594142259,2011,-0.336569037656904
KY,Warren County,21227,16966,28673,48416,0.350421348314607,0.592221579643093,11707,-0.241800231328486,21227,43889,16805,26384,227,21,0.382897764815785,0.601152908473649,9579,-0.218255143657864
KY,Washington County,21229,1420,4013,5621,0.252624088240527,0.713929905710728,2593,-0.461305817470201,21229,5218,1669,3495,229,21,0.319854350325795,0.669796857033346,1826,-0.349942506707551
KY,Wayne County,21231,1431,6370,7988,0.17914371557336,0.797446169253881,4939,-0.618302453680521,21231,7210,1855,5289,231,21,0.257281553398058,0.733564493758669,3434,-0.47628294036061
KY,Webster County,21233,1240,4397,5804,0.213645761543763,0.757580978635424,3157,-0.543935217091661,21233,5470,1765,3607,233,21,0.322669104204753,0.659414990859232,1842,-0.336745886654479
KY,Whitley County,21235,2067,11312,13765,0.150163458045768,0.821794406102434,9245,-0.671630948056665,21235,13068,2683,10232,235,21,0.20531068258341,0.782981328435874,7549,-0.577670645852464
KY,Wolfe County,21237,753,1804,2634,0.285876993166287,0.684889901290812,1051,-0.399012908124525,21237,2559,976,1542,237,21,0.381398983978116,0.602579132473622,566,-0.221180148495506
KY,Woodford County,21239,4958,7697,13547,0.365985088949583,0.568170074555252,2739,-0.202184985605669,21239,12331,4883,7218,239,21,0.395993836671803,0.585353985889222,2335,-0.18936014921742
LA,Acadia Parish,22001,5638,21159,27386,0.205871613233039,0.77262104725042,15521,-0.566749434017381,22001,26834,6559,19931,1,22,0.244428709845718,0.742751732876202,13372,-0.498323023030484
LA,Allen Parish,22003,2106,6867,9245,0.227798810167658,0.742779881016766,4761,-0.514981070849108,22003,9306,2616,6495,3,22,0.281108961960026,0.697936814958092,3879,-0.416827852998066
LA,Ascension Parish,22005,16471,36135,54663,0.301318990907927,0.661050436309752,19664,-0.359731445401826,22005,51056,16343,33846,5,22,0.320099498589784,0.662919147602632,17503,-0.342819649012849
LA,Assumption Parish,22007,3931,6714,10904,0.360509904622157,0.61573734409391,2783,-0.255227439471754,22007,10991,4754,6082,7,22,0.432535711036303,0.553361841506687,1328,-0.120826130470385
LA,Avoyelles Parish,22009,5032,11163,16581,0.303479886617212,0.67324045594355,6131,-0.369760569326337,22009,17027,6075,10667,9,22,0.356786280613144,0.626475597580314,4592,-0.26968931696717
LA,Beauregard Parish,22011,2393,12238,15078,0.158708051465712,0.811646106910731,9845,-0.652938055445019,22011,14223,2827,11111,11,22,0.19876256767208,0.781199465654222,8284,-0.582436897982142
LA,Bienville Parish,22013,3129,3756,7005,0.446680942184154,0.536188436830835,627,-0.089507494646681,22013,7203,3490,3641,13,22,0.484520338747744,0.505483826183535,151,-0.020963487435791
LA,Bossier Parish,22015,12638,35451,49818,0.253683407603677,0.711610261351319,22813,-0.457926853747641,22015,48559,12955,34986,15,22,0.266788854795198,0.720484359233098,22031,-0.4536955044379
LA,Caddo Parish,22017,53448,48977,105737,0.505480579172853,0.463196421309475,4471,0.042284157863378,22017,111516,57879,52378,17,22,0.519019692241472,0.469690448007461,5501,0.049329244234011
LA,Calcasieu Parish,22019,26293,54182,83773,0.313860074248266,0.646771632865004,27889,-0.332911558616738,22019,81718,28357,51844,19,22,0.347010450573925,0.634425707922367,23487,-0.287415257348442
LA,Caldwell Parish,22021,788,3822,4692,0.167945439045183,0.814578005115089,3034,-0.646632566069906,22021,4716,1016,3640,21,22,0.215436810856658,0.771840542832909,2624,-0.556403731976251
LA,Cameron Parish,22023,323,3256,3692,0.087486457204767,0.881906825568797,2933,-0.79442036836403,22023,3744,408,3260,23,22,0.108974358974359,0.870726495726496,2852,-0.761752136752137
LA,Catahoula Parish,22025,1322,3479,4856,0.272240527182867,0.716433278418451,2157,-0.444192751235585,22025,4193,1408,2744,25,22,0.335797758168376,0.654424040066778,1336,-0.318626281898402
LA,Claiborne Parish,22027,2717,3585,6421,0.423142812646005,0.558324248559414,868,-0.135181435913409,22027,6732,3014,3649,27,22,0.447712418300654,0.542038027332145,635,-0.094325609031491
LA,Concordia Parish,22029,3272,5474,8869,0.368925470740782,0.617205998421468,2202,-0.248280527680686,22029,9380,3833,5450,29,22,0.40863539445629,0.581023454157783,1617,-0.172388059701493
LA,De Soto Parish,22031,5163,8067,13497,0.382529450989109,0.597688375194488,2904,-0.215158924205379,22031,13050,5552,7353,31,22,0.42544061302682,0.563448275862069,1801,-0.138007662835249
LA,East Baton Rouge Parish,22033,102711,84620,196332,0.523149562985148,0.431004624819184,18091,0.092144938165964,22033,197912,102460,92235,33,22,0.517704838514087,0.466040462427746,10225,0.051664376086342
LA,East Carroll Parish,22035,1838,1059,2939,0.625382783259612,0.360326641714869,779,0.265056141544743,22035,3384,2244,1122,35,22,0.663120567375887,0.331560283687943,1122,0.331560283687943
LA,East Feliciana Parish,22037,4235,5569,10042,0.421728739294961,0.554570802628958,1334,-0.132842063333997,22037,10209,4648,5397,37,22,0.455284552845528,0.528651190126359,749,-0.073366637280831
LA,Evangeline Parish,22039,4208,10357,14879,0.282814705289334,0.696081725922441,6149,-0.413267020633107,22039,15765,5330,10176,39,22,0.338090707262924,0.645480494766889,4846,-0.307389787503964
LA,Franklin Parish,22041,2506,6514,9162,0.273521065269592,0.710980135341629,4008,-0.437459070072037,22041,9336,2921,6294,41,22,0.312874892887746,0.674164524421594,3373,-0.361289631533847
LA,Grant Parish,22043,1181,7406,8819,0.133915409910421,0.839777752579658,6225,-0.705862342669237,22043,8666,1421,7082,43,22,0.163974151857835,0.817216708977614,5661,-0.653242557119778
LA,Iberia Parish,22045,10698,20903,32454,0.329635792198188,0.644080852899488,10205,-0.3144450607013,22045,33392,12129,20890,45,22,0.363230713943459,0.625598945855295,8761,-0.262368231911835
LA,Iberville Parish,22047,8324,7320,16043,0.518855575640466,0.456273764258555,1004,0.062581811381911,22047,17014,9548,7271,47,22,0.561184906547549,0.427353943810979,2277,0.13383096273657
LA,Jackson Parish,22049,2139,5169,7464,0.286575562700965,0.692524115755627,3030,-0.405948553054662,22049,7529,2305,5132,49,22,0.306149555053792,0.681631026696772,2827,-0.37548147164298
LA,Jefferson Parish,22051,73540,100292,181388,0.405429245595078,0.552914194985335,26752,-0.147484949390257,22051,175733,70000,102325,51,22,0.398331559809484,0.582275383678649,32325,-0.183943823869165
LA,Jefferson Davis Parish,22053,3080,10775,14277,0.215731596273727,0.75471037332773,7695,-0.538978777054003,22053,13733,3483,10014,53,22,0.253622660744193,0.729192456127576,6531,-0.475569795383383
LA,Lafayette Parish,22055,32726,68191,105599,0.309908237767403,0.645754221157397,35465,-0.335845983389994,22055,98637,31766,64989,55,22,0.322049535164289,0.658870403601083,33223,-0.336820868436793
LA,Lafourche Parish,22057,8423,31958,41644,0.202262030544616,0.767409470752089,23535,-0.565147440207473,22057,38725,9543,28332,57,22,0.246429954809555,0.731620400258231,18789,-0.485190445448677
LA,La Salle Parish,22059,605,5835,6568,0.092113276492083,0.888398294762485,5230,-0.796285018270402,22059,6572,764,5726,59,22,0.116250760803408,0.871272063298843,4962,-0.755021302495435
LA,Lincoln Parish,22061,7102,10761,18664,0.380518645520789,0.576564509215602,3659,-0.196045863694814,22061,18974,7947,10731,61,22,0.418836302308422,0.565563402550859,2784,-0.146727100242437
LA,Livingston Parish,22063,6950,48797,57700,0.120450606585789,0.845701906412478,41847,-0.72525129982669,22063,54033,7448,45488,63,22,0.137841689337997,0.841855902874169,38040,-0.704014213536172
LA,Madison Parish,22065,2744,1927,4732,0.579881656804734,0.407227387996619,817,0.172654268808115,22065,5187,3154,2000,65,22,0.608058608058608,0.385579332947754,1154,0.222479275110854
LA,Morehouse Parish,22067,5155,6502,11852,0.434947688153898,0.548599392507594,1347,-0.113651704353696,22067,12613,5887,6591,67,22,0.466740664393879,0.522556092920003,704,-0.055815428526124
LA,Natchitoches Parish,22069,7143,8965,16617,0.429860985737498,0.539507733044472,1822,-0.109646747306975,22069,17257,7941,9077,69,22,0.460161094048792,0.525989453555079,1136,-0.065828359506287
LA,Orleans Parish,22071,133833,24267,165619,0.808077575640476,0.146523043853664,109566,0.661554531786812,22071,157233,126199,27967,71,22,0.802624131066633,0.177869785604803,98232,0.624754345461831
LA,Ouachita Parish,22073,24420,41712,67987,0.359186315030815,0.613529057025608,17292,-0.254342741994793,22073,68437,26629,40927,73,22,0.389102386136154,0.598024460452679,14298,-0.208922074316525
LA,Plaquemines Parish,22075,3347,6900,10572,0.316590995081347,0.65266742338252,3553,-0.336076428301173,22075,10235,3597,6469,75,22,0.351441133365901,0.632046897899365,2872,-0.280605764533464
LA,Pointe Coupee Parish,22077,4764,6789,11761,0.405067596292832,0.577246832752317,2025,-0.172179236459485,22077,12147,5436,6548,77,22,0.447517905655718,0.539063143162921,1112,-0.091545237507204
LA,Rapides Parish,22079,18318,36814,56838,0.322284387205743,0.647700482071853,18496,-0.325416094866111,22079,58008,20040,37187,79,22,0.345469590401324,0.641066749413874,17147,-0.29559715901255
LA,Red River Parish,22081,1938,2391,4422,0.438263229308005,0.540705563093623,453,-0.102442333785617,22081,4807,2253,2483,81,22,0.468691491574787,0.51653838152694,230,-0.047846889952153
LA,Richland Parish,22083,3157,6286,9596,0.328991246352647,0.655064610254273,3129,-0.326073363901626,22083,11507,4074,7316,83,22,0.354045363691666,0.635786912314244,3242,-0.281741548622578
LA,Sabine Parish,22085,1703,7877,9785,0.174041900868677,0.805007664793051,6174,-0.630965763924374,22085,10050,2194,7735,85,22,0.218308457711443,0.769651741293532,5541,-0.55134328358209
LA,St. Bernard Parish,22087,4957,10232,15807,0.313595242614032,0.647308154615044,5275,-0.333712912001012,22087,13944,5052,8497,87,22,0.362306368330465,0.609366035570855,3445,-0.24705966724039
LA,St. Charles Parish,22089,8558,16620,26190,0.326765941198931,0.634593356242841,8062,-0.30782741504391,22089,25330,8894,15936,89,22,0.351125148045795,0.629135412554284,7042,-0.278010264508488
LA,St. Helena Parish,22091,3353,2497,5964,0.562206572769953,0.418678739101274,856,0.143527833668679,22091,7093,4233,2756,91,22,0.596785563231355,0.388552093613422,1477,0.208233469617933
LA,St. James Parish,22093,6418,5456,12085,0.531071576334299,0.451468762929251,962,0.079602813405048,22093,12391,7055,5209,93,22,0.569364861593092,0.420385763860867,1846,0.148979097732225
LA,St. John the Baptist Parish,22095,12658,7569,20740,0.610318225650916,0.364946962391514,5089,0.245371263259402,22095,21122,13178,7620,95,22,0.623899251964776,0.360761291544361,5558,0.263137960420415
LA,St. Landry Parish,22097,17208,21966,39970,0.430522892169127,0.549562171628722,4758,-0.119039279459595,22097,41647,19668,21475,97,22,0.472254904314837,0.515643383677096,1807,-0.043388479362259
LA,St. Martin Parish,22099,8266,16872,25749,0.321022175618471,0.655248747524176,8606,-0.334226571905705,22099,25430,9419,15653,99,22,0.370389303971687,0.615532835233976,6234,-0.245143531262289
LA,St. Mary Parish,22101,8050,14353,22871,0.351974115692362,0.627563289755586,6303,-0.275589174063224,22101,23636,9448,13883,101,22,0.399729226603486,0.587366728718903,4435,-0.187637502115417
LA,St. Tammany Parish,22103,27716,90914,124389,0.222817130132086,0.730884563747598,63198,-0.508067433615513,22103,112884,25723,84710,103,22,0.227871088905425,0.750416356613869,58987,-0.522545267708444
LA,Tangipahoa Parish,22105,16869,33933,52381,0.322044252687043,0.647811229262519,17064,-0.325766976575476,22105,50090,17720,31583,105,22,0.353763226192853,0.630525054901178,13863,-0.276761828708325
LA,Tensas Parish,22107,1329,1180,2543,0.522611089264648,0.464018875344082,149,0.058592213920566,22107,2812,1564,1230,107,22,0.556187766714083,0.437411095305832,334,0.11877667140825
LA,Terrebonne Parish,22109,10664,31900,43893,0.24295445743057,0.726767366094821,21236,-0.483812908664252,22109,42335,12071,29500,109,22,0.285130506672966,0.696822959725995,17429,-0.411692453053029
LA,Union Parish,22111,2691,7972,10894,0.247016706443914,0.731778960895906,5281,-0.484762254451992,22111,10766,3075,7561,111,22,0.285621400705926,0.702303548207319,4486,-0.416682147501393
LA,Vermilion Parish,22113,4745,19807,25253,0.187898467508811,0.784342454361858,15062,-0.596443986853047,22113,24984,5718,18909,113,22,0.228866474543708,0.756844380403458,13191,-0.52797790585975
LA,Vernon Parish,22115,2665,13471,16633,0.160223651776589,0.809895989899597,10806,-0.649672338123009,22115,15606,3173,12146,115,22,0.203319236191208,0.778290401127771,8973,-0.574971164936563
LA,Washington Parish,22117,5690,12552,18622,0.305552572226399,0.674041456341961,6862,-0.368488884115562,22117,18100,6351,11470,117,22,0.350883977900552,0.633701657458563,5119,-0.282817679558011
LA,Webster Parish,22119,6259,11538,18140,0.345038588754135,0.636052921719956,5279,-0.291014332965821,22119,18413,6802,11397,119,22,0.369412914788465,0.618964861782436,4595,-0.249551946993972
LA,West Baton Rouge Parish,22121,5382,6926,12710,0.423446105428796,0.54492525570417,1544,-0.121479150275374,22121,12772,5692,6920,121,22,0.445662386470404,0.541810209834012,1228,-0.096147823363608
LA,West Carroll Parish,22123,715,3970,4759,0.150241647404917,0.83420886740912,3255,-0.683967220004203,22123,4548,853,3628,123,22,0.187554969217238,0.797713280562885,2775,-0.610158311345646
LA,West Feliciana Parish,22125,2247,3390,5798,0.387547430148327,0.584684373922042,1143,-0.197136943773715,22125,5777,2441,3257,125,22,0.422537649298944,0.563787432923663,816,-0.141249783624719
LA,Winn Parish,22127,1643,4605,6368,0.258008793969849,0.723146984924623,2962,-0.465138190954774,22127,6532,1919,4539,127,22,0.293784445805266,0.694886711573791,2620,-0.401102265768524
ME,Androscoggin County,23001,22975,28189,55340,0.415160823997109,0.509378388146007,5214,-0.094217564148898,23001,52539,28912,22210,1,23,0.550295970612307,0.422733588381964,6702,0.127562382230343
ME,Aroostook County,23003,13377,19419,34963,0.382604467580013,0.555415725195206,6042,-0.172811257615193,23003,33866,17844,15229,3,23,0.526900135829446,0.4496840488986,2615,0.077216086930845
ME,Cumberland County,23005,102935,57697,171249,0.601083801949208,0.33691875572996,45238,0.264165046219248,23005,166895,100977,57008,5,23,0.605033104646634,0.341580035351568,43969,0.263453069295066
ME,Franklin County,23007,7001,7900,16382,0.427359296789159,0.482236601147601,899,-0.054877304358442,23007,16112,9292,6305,7,23,0.576713008937438,0.39132323733863,2987,0.185389771598808
ME,Hancock County,23009,16107,13682,31983,0.503611293499672,0.427789763311759,2425,0.075821530187912,23009,30738,17533,12398,9,23,0.570401457479342,0.403344394560479,5135,0.167057062918863
ME,Kennebec County,23011,29296,31753,65999,0.44388551341687,0.481113350202276,2457,-0.037227836785406,23011,63225,35022,26506,11,23,0.553926453143535,0.419232898378806,8516,0.134693554764729
ME,Knox County,23013,12440,9148,23021,0.540376178272013,0.397376308587811,3292,0.142999869684201,23013,22002,13227,8262,13,23,0.601172620670848,0.375511317152986,4965,0.225661303517862
ME,Lincoln County,23015,10241,9727,21432,0.477836879432624,0.453854050018664,514,0.02398282941396,23015,20668,11298,8884,15,23,0.546642152119218,0.429843235920263,2414,0.116798916198955
ME,Oxford County,23017,12172,16214,31094,0.391458159130379,0.521451083810381,4042,-0.129992924680003,23017,28734,16052,11766,17,23,0.558641330827591,0.409480058467321,4286,0.14916127236027
ME,Penobscot County,23019,32832,41601,80228,0.409233684000598,0.518534676172907,8769,-0.109300992172309,23019,77171,38816,36592,19,23,0.502986873307331,0.474167757318164,2224,0.028819115989167
ME,Piscataquis County,23021,3098,5403,9144,0.338801399825022,0.590879265091863,2305,-0.252077865266842,23021,8990,4168,4577,21,23,0.463626251390434,0.509121245828699,409,-0.045494994438265
ME,Sagadahoc County,23023,10679,9304,21596,0.494489720318577,0.430820522318948,1375,0.06366919799963,23023,20734,11821,8429,23,23,0.570126362496383,0.406530336645124,3392,0.163596025851259
ME,Somerset County,23025,9092,14998,25968,0.350123228589033,0.577556993222428,5906,-0.227433764633395,23025,24705,12211,11798,25,23,0.494272414490994,0.477555150779194,413,0.016717263711799
ME,Waldo County,23027,10442,10378,22630,0.461422889969068,0.458594785682722,64,0.002828104286346,23027,20976,11292,9055,27,23,0.538329519450801,0.431683829138062,2237,0.106645690312738
ME,Washington County,23029,6358,9037,16559,0.383960384081164,0.545745516033577,2679,-0.161785131952413,23029,15756,7797,7539,29,23,0.494859101294745,0.478484386900229,258,0.016374714394516
ME,York County,23031,55828,50388,113962,0.489882592443095,0.44214738246082,5440,0.047735209982275,23031,107627,61492,43879,31,23,0.571343621953599,0.407695095096955,17613,0.163648526856644
MD,Allegany County,24001,6665,20025,27804,0.239713710257517,0.72022011221407,13360,-0.480506401956553,24001,27817,9001,18158,1,24,0.323579106301902,0.652766293992882,9157,-0.32918718769098
MD,Anne Arundel County,24003,116074,114509,242939,0.477790721127526,0.471348774795319,1565,0.006441946332207,24003,239189,115960,118165,3,24,0.484804903235517,0.494023554594902,2205,-0.009218651359385
MD,Baltimore County,24005,189437,131009,335017,0.565454887363925,0.391051797371477,58428,0.174403089992448,24005,354655,202733,144686,5,24,0.571634405267091,0.407962667944904,58047,0.163671737322186
MD,Calvert County,24009,16669,24680,43445,0.38368051559443,0.568074577051444,8011,-0.184394061457015,24009,42168,18963,22413,9,24,0.449701195219124,0.531516789982925,3450,-0.081815594763802
MD,Caroline County,24011,3747,8999,13282,0.282111127842192,0.677533503990363,5252,-0.39542237614817,24011,12526,4621,7674,11,24,0.368912661663739,0.612645696950343,3053,-0.243733035286604
MD,Carroll County,24013,24314,55593,84879,0.286454835707301,0.654967659845191,31279,-0.36851282413789,24013,82171,26067,53960,13,24,0.317228705991165,0.656679363765806,27893,-0.339450657774641
MD,Cecil County,24015,12651,27579,42309,0.299014394100546,0.651847124725236,14928,-0.35283273062469,24015,40037,15489,23660,15,24,0.386867147888203,0.590953368134476,8171,-0.204086220246272
MD,Charles County,24017,46063,24163,72480,0.635527041942605,0.33337472406181,21900,0.302152317880795,24017,70167,45621,23637,17,24,0.650177433836419,0.336867758347941,21984,0.313309675488477
MD,Dorchester County,24019,5695,7938,14034,0.405800199515462,0.565626336041043,2243,-0.159826136525581,24019,14249,6570,7514,19,24,0.46108498842024,0.527335251596603,944,-0.066250263176363
MD,Frederick County,24021,51891,56472,114962,0.451375237034846,0.491223186792158,4581,-0.039847949757311,24021,109127,51187,55495,21,24,0.469058986318693,0.508535926031138,4308,-0.039476939712445
MD,Garrett County,24023,2252,10189,12905,0.174506005424254,0.789538938395971,7937,-0.615032932971716,24023,12113,2792,9102,23,24,0.230496161149179,0.751424089820854,6310,-0.520927928671675
MD,Harford County,24025,43803,74261,124224,0.352613021638331,0.597799137042761,30458,-0.245186115404431,24025,118417,46390,69496,25,24,0.391751184373865,0.586875195284461,23106,-0.195124010910596
MD,Howard County,24027,93808,44792,146401,0.640760650542005,0.305954194301951,49016,0.334806456240053,24027,141167,84017,54094,27,24,0.595160342006276,0.383191539099081,29923,0.211968802907195
MD,Kent County,24029,4178,4598,9166,0.455814968361335,0.501636482653284,420,-0.045821514291949,24029,9143,4453,4533,29,24,0.487039265011484,0.49578912829487,80,-0.008749863283386
MD,Montgomery County,24031,309761,82985,408300,0.758660298799902,0.203245162870438,226776,0.555415135929464,24031,404214,286493,110940,31,24,0.708765653836829,0.274458578871588,175553,0.434307074965241
MD,Prince George's County,24033,313627,29290,351091,0.893292622140699,0.083425664571294,284337,0.809866957569405,24033,352292,317342,32236,33,24,0.900792524383182,0.091503639026717,285106,0.809288885356466
MD,Queen Anne's County,24035,7316,16211,24633,0.296999959404051,0.658100921528031,8895,-0.36110096212398,24035,23153,7898,14879,35,24,0.341122100807671,0.6426381030536,6981,-0.301516002245929
MD,St. Mary's County,24037,15786,26889,45169,0.349487480351569,0.595297659899489,11103,-0.24581017954792,24037,44076,17982,25096,37,24,0.407977130411108,0.56938016153916,7114,-0.161403031128051
MD,Somerset County,24039,3484,5056,8768,0.39735401459854,0.576642335766423,1572,-0.179288321167883,24039,9272,4478,4706,39,24,0.482959447799827,0.507549611734254,228,-0.024590163934426
MD,Talbot County,24041,7865,10098,18731,0.419892157386151,0.539106294378303,2233,-0.119214136992152,24041,18671,7983,10442,41,24,0.42756145894703,0.55926302822559,2459,-0.13170156927856
MD,Washington County,24043,19193,38842,60731,0.316032997974675,0.63957451713293,19649,-0.323541519158255,24043,58653,23282,34113,43,24,0.396944742809404,0.581607078921794,10831,-0.18466233611239
MD,Wicomico County,24045,16327,20832,38722,0.42164660916275,0.53798874025102,4505,-0.11634213108827,24045,38256,17481,20136,45,24,0.456947929736512,0.526348808030113,2655,-0.069400878293601
MD,Worcester County,24047,8783,15910,25571,0.343475030307771,0.622189198701654,7127,-0.278714168393884,24047,24526,9841,14334,47,24,0.401247655549213,0.584441001386284,4493,-0.183193345837071
MD,Baltimore city,24510,178562,22726,208980,0.854445401473825,0.10874724854053,155836,0.745698152933295,24510,229897,201042,25501,510,24,0.874487270386303,0.110923587519628,175541,0.763563682866675
MA,Barnstable County,25001,71632,53842,132667,0.539938341863463,0.405843201398991,17790,0.134095140464471,25001,132212,70329,60221,1,25,0.531941124860073,0.455488155386803,10108,0.07645296947327
MA,Berkshire County,25003,43540,16799,64507,0.674965507619328,0.260421349620971,26741,0.414544157998357,25003,64078,48596,14209,3,25,0.758388214363744,0.221745372826867,34387,0.536642841536877
MA,Bristol County,25005,127619,104775,246068,0.518633060779947,0.425796934180796,22844,0.092836126599151,25005,239565,142481,93448,5,25,0.594748815561539,0.390073675202972,49033,0.204675140358567
MA,Dukes County,25007,8338,2474,11434,0.729228616407207,0.216372223193983,5864,0.512856393213224,25007,10914,7955,2789,7,25,0.728880337181602,0.255543338830859,5166,0.473336998350742
MA,Essex County,25009,220027,135405,376140,0.584960387089913,0.359985643643324,84622,0.224974743446589,25009,363246,208723,149808,9,25,0.574605088562572,0.41241472720966,58915,0.162190361352912
MA,Franklin County,25011,24369,10327,37987,0.641508937268013,0.271856161318346,14042,0.369652775949667,25011,37600,27024,9338,11,25,0.718723404255319,0.248351063829787,17686,0.470372340425532
MA,Hampden County,25013,110313,78230,200220,0.550958945160324,0.390720207771451,32083,0.160238737388872,25013,197827,122571,72318,13,25,0.619586810698236,0.365561829275074,50253,0.254024981423163
MA,Hampshire County,25015,54572,22089,82329,0.662852700749432,0.268301570528003,32483,0.394551130221429,25015,80406,56552,21366,15,25,0.703330597219113,0.265726438325498,35186,0.437604158893615
MA,Middlesex County,25017,508919,216163,767337,0.663227499781713,0.281705430599593,292756,0.381522069182119,25017,746856,467173,266307,17,25,0.625519511123965,0.3565707445612,200866,0.268948766562764
MA,Nantucket County,25019,4144,1892,6404,0.647095565271705,0.295440349781387,2252,0.351655215490319,25019,6097,3828,2185,19,25,0.62784976217812,0.358372970313269,1643,0.269476791864852
MA,Norfolk County,25021,219129,119171,357781,0.612466844242707,0.333083646141075,99958,0.279383198101632,25021,350195,200891,144654,21,25,0.573654678107911,0.413067005525493,56237,0.160587672582418
MA,Plymouth County,25023,133828,114722,264168,0.506601859422792,0.434276672420581,19106,0.072325187002211,25023,253993,130278,120708,23,25,0.512919647391857,0.475241443661833,9570,0.037678203730024
MA,Suffolk County,25025,241212,50042,303517,0.794723195076388,0.16487379619593,191170,0.629849398880458,25025,282649,219208,58872,25,25,0.775548471779486,0.208286602818336,160336,0.56726186896115
MA,Worcester County,25027,197126,157138,380972,0.517429102401226,0.412466008000588,39988,0.104963094400638,25027,364093,195667,162022,27,25,0.537409398148275,0.445001689128876,33645,0.092407709019399
MI,Alcona County,26001,1732,4201,6179,0.280304256352161,0.679883476290662,2469,-0.399579219938501,26001,6086,2462,3571,1,26,0.404534998356885,0.58675649030562,1109,-0.182221491948735
MI,Alger County,26003,1663,2585,4513,0.368491025925105,0.572789718590738,922,-0.204298692665633,26003,4603,2212,2329,3,26,0.480556159026722,0.505974364544862,117,-0.02541820551814
MI,Allegan County,26005,17932,33812,55153,0.32513190578935,0.613058219861114,15880,-0.287926314071764,26005,49199,19594,29023,5,26,0.398260127238358,0.589910364031789,9429,-0.191650236793431
MI,Alpena County,26007,4877,9090,14688,0.332039760348584,0.618872549019608,4213,-0.286832788671024,26007,14014,6549,7298,7,26,0.467318395889824,0.520764949336378,749,-0.053446553446554
MI,Antrim County,26009,4448,8469,13572,0.327733569112879,0.624005305039788,4021,-0.296271735926908,26009,13184,5107,7917,9,26,0.387363470873786,0.600500606796116,2810,-0.21313713592233
MI,Arenac County,26011,2238,4704,7457,0.300120691967279,0.630816682311922,2466,-0.330695990344643,26011,7826,3669,4054,11,26,0.46882187579862,0.518016866854076,385,-0.049194991055456
MI,Baraga County,26013,1156,2158,3486,0.331612162937464,0.619047619047619,1002,-0.287435456110155,26013,3490,1574,1866,13,26,0.451002865329513,0.534670487106017,292,-0.083667621776504
MI,Barry County,26015,9109,19197,30265,0.300974723277713,0.6342970427887,10088,-0.333322319510986,26015,28483,11496,16651,15,26,0.403609170382333,0.584594319418601,5155,-0.180985149036267
MI,Bay County,26017,21641,28327,52932,0.408845310965012,0.535158316330386,6686,-0.126313005365374,26017,51077,26797,23735,17,26,0.524639270121581,0.464690565225052,3062,0.059948704896529
MI,Benzie County,26019,4108,5539,10221,0.40191762058507,0.541923490852167,1431,-0.140005870267097,26019,9847,4683,5071,19,26,0.475576317660201,0.514979181476592,388,-0.039402863816391
MI,Berrien County,26021,29496,38646,71882,0.410339166968087,0.537631117665062,9150,-0.127291950696976,26021,72322,33465,38209,21,26,0.462722269848732,0.52831780094577,4744,-0.065595531097038
MI,Branch County,26023,4740,11025,16490,0.287446937537902,0.668587022437841,6285,-0.381140084899939,26023,16278,6526,9575,23,26,0.400909202604743,0.588217225703403,3049,-0.187308023098661
MI,Calhoun County,26025,24154,31489,58786,0.410880141530296,0.535654747729051,7335,-0.124774606198755,26025,58231,29270,28338,25,26,0.502653225944943,0.486648005357971,932,0.016005220586973
MI,Cass County,26027,7270,14241,23272,0.312392574767961,0.611937091784118,6971,-0.299544517016157,26027,22461,9587,12660,27,26,0.426828725346156,0.563643648991585,3073,-0.13681492364543
MI,Charlevoix County,26029,5137,8674,14567,0.352646392531063,0.595455481567927,3537,-0.242809089036864,26029,14064,5936,7997,29,26,0.422070534698521,0.568614903299204,2061,-0.146544368600683
MI,Cheboygan County,26031,4302,8680,13647,0.315234117388437,0.636037224298381,4378,-0.320803106909944,26031,13288,5829,7284,31,26,0.438666465984347,0.548163756773028,1455,-0.109497290788682
MI,Chippewa County,26033,5378,9120,15434,0.3484514707788,0.590903200725671,3742,-0.242451729946871,26033,15564,7100,8278,33,26,0.456180930352095,0.531868414289386,1178,-0.075687483937291
MI,Clare County,26035,4250,8507,13385,0.317519611505416,0.635562196488607,4257,-0.31804258498319,26035,13492,6337,6988,35,26,0.469685739697599,0.517936554995553,651,-0.048250815297954
MI,Clinton County,26037,16490,21635,40564,0.40651809486244,0.533354698747658,5145,-0.126836603885218,26037,39125,18187,20630,37,26,0.464843450479233,0.527284345047923,2443,-0.06244089456869
MI,Crawford County,26039,2110,4354,6833,0.308795551002488,0.637201814722669,2244,-0.328406263720181,26039,6814,2994,3744,39,26,0.439389492221896,0.549457000293513,750,-0.110067508071617
MI,Delta County,26041,6431,11112,18467,0.348242811501597,0.601721990577787,4681,-0.25347917907619,26041,18043,8330,9533,41,26,0.461674887768109,0.528348944188882,1203,-0.066674056420773
MI,Dickinson County,26043,3923,8580,13140,0.29855403348554,0.65296803652968,4657,-0.35441400304414,26043,12785,4952,7688,43,26,0.387328901055925,0.601329683222526,2736,-0.214000782166601
MI,Eaton County,26045,24534,27608,55686,0.44057752397371,0.495779908774198,3074,-0.055202384800489,26045,54707,27912,26193,45,26,0.510208931215384,0.478786992523809,1719,0.031421938691575
MI,Emmet County,26047,6972,10616,18774,0.371364653243848,0.565462874187706,3644,-0.194098220943859,26047,17672,7225,10253,47,26,0.408838841104572,0.580183340878225,3028,-0.171344499773653
MI,Genesee County,26049,102744,84174,196135,0.523843271216254,0.429163586305351,18570,0.094679684910903,26049,202699,128972,71807,49,26,0.636273489262404,0.354254337712569,57165,0.282019151549835
MI,Gladwin County,26051,3794,8124,12472,0.304201411161001,0.651379089159718,4330,-0.347177677998717,26051,12552,5760,6661,51,26,0.458891013384321,0.530672402804334,901,-0.071781389420013
MI,Gogebic County,26053,2925,4019,7313,0.399972651442636,0.549569260221523,1094,-0.149596608778887,26053,7576,4058,3444,53,26,0.535638859556494,0.454593453009504,614,0.081045406546991
MI,Grand Traverse County,26055,20964,27412,51460,0.407384376214536,0.532685581033813,6448,-0.125301204819277,26055,47901,20875,26532,55,26,0.435794659819211,0.553892403081355,5657,-0.118097743262145
MI,Gratiot County,26057,5665,9878,16442,0.344544459311519,0.600778494100474,4213,-0.256234034788955,26057,16011,7606,8236,57,26,0.475048404222097,0.514396352507651,630,-0.039347948285554
MI,Hillsdale County,26059,4799,14094,19880,0.241398390342052,0.708953722334004,9295,-0.467555331991952,26059,19081,7106,11727,59,26,0.372412347361249,0.61459043027095,4621,-0.242178082909701
MI,Houghton County,26061,6018,8475,15623,0.385201305767138,0.542469436087819,2457,-0.157268130320681,26061,14804,6530,8040,61,26,0.441097000810592,0.543096460416104,1510,-0.101999459605512
MI,Huron County,26063,4579,10629,15848,0.288932357395255,0.670683997980818,6050,-0.381751640585563,26063,15274,6432,8686,63,26,0.421107764829121,0.568678800576143,2254,-0.147571035747021
MI,Ingham County,26065,81266,44354,133478,0.608834414660094,0.332294460510346,36912,0.276539954149747,26065,127579,80903,45365,65,26,0.634140414958575,0.355583599181684,35538,0.278556815776891
MI,Ionia County,26067,8206,16374,26364,0.311257775754817,0.621074192080109,8168,-0.309816416325292,26067,25730,11016,14319,67,26,0.428138359891178,0.556509910610183,3303,-0.128371550719005
MI,Iosco County,26069,4344,8344,13349,0.325417634279721,0.625065547981122,4000,-0.299647913701401,26069,13330,6242,6906,69,26,0.468267066766692,0.51807951987997,664,-0.049812453113278
MI,Iron County,26071,2004,3675,5910,0.339086294416244,0.621827411167513,1671,-0.282741116751269,26071,5987,2687,3224,71,26,0.448805745782529,0.538500083514281,537,-0.089694337731752
MI,Isabella County,26073,11404,12338,25344,0.449968434343434,0.486821338383838,934,-0.036852904040404,26073,24119,13038,10800,73,26,0.540569675359675,0.447779758696463,2238,0.092789916663212
MI,Jackson County,26075,25795,39793,69567,0.3707936234134,0.572009717250996,13998,-0.201216093837595,26075,69323,32301,36298,75,26,0.465949252051989,0.523606883718246,3997,-0.057657631666258
MI,Kalamazoo County,26077,67142,51031,125966,0.533016845815538,0.405117253862153,16111,0.127899591953384,26077,122880,69045,52660,77,26,0.5618896484375,0.428548177083333,16385,0.133341471354167
MI,Kalkaska County,26079,2279,6213,8920,0.255493273542601,0.69652466367713,3934,-0.441031390134529,26079,8281,3268,4897,79,26,0.394638328704263,0.591353701243811,1629,-0.196715372539548
MI,Kent County,26081,138567,147959,306270,0.452434126750906,0.483099879191563,9392,-0.030665752440657,26081,295418,134560,157801,81,26,0.455490186786181,0.534161764008964,23241,-0.078671577222783
MI,Keweenaw County,26083,527,814,1429,0.368789363191043,0.56962911126662,287,-0.200839748075577,26083,1388,582,774,83,26,0.419308357348703,0.557636887608069,192,-0.138328530259366
MI,Lake County,26085,1939,3159,5328,0.363926426426426,0.592905405405405,1220,-0.228978978978979,26085,5287,2752,2487,85,26,0.520522035180632,0.470399092112729,265,0.050122943067903
MI,Lapeer County,26087,12734,30037,45126,0.282187652351194,0.665625138501086,17303,-0.383437486149891,26087,43025,18786,23725,87,26,0.436629866356769,0.551423590935503,4939,-0.114793724578733
MI,Leelanau County,26089,6774,7239,14757,0.459036389510063,0.490546859117707,465,-0.031510469607644,26089,14164,6576,7483,89,26,0.464275628353573,0.528311211522169,907,-0.064035583168597
MI,Lenawee County,26091,16750,26428,45895,0.364963503649635,0.575836147728511,9678,-0.210872644078876,26091,44619,21774,22351,91,26,0.487998386337659,0.50093009704386,577,-0.012931710706202
MI,Livingston County,26093,34378,65665,105577,0.325620163482577,0.621963116966764,31287,-0.296342953484187,26093,97959,37186,60000,93,26,0.379607795097949,0.612501148439653,22814,-0.232893353341704
MI,Luce County,26095,681,1756,2576,0.264363354037267,0.68167701863354,1075,-0.417313664596273,26095,2477,951,1501,95,26,0.383932176019378,0.605974969721437,550,-0.222042793702059
MI,Mackinac County,26097,2085,3740,6088,0.342477003942181,0.614323258869908,1655,-0.271846254927727,26097,6097,2652,3396,97,26,0.434968017057569,0.556995243562408,744,-0.122027226504838
MI,Macomb County,26099,176238,224589,418773,0.420843750671605,0.536302483684478,48351,-0.115458733012873,26099,403388,207992,191896,99,26,0.515612759923448,0.475710730115918,16096,0.03990202980753
MI,Manistee County,26101,4979,6915,12598,0.395221463724401,0.548896650261946,1936,-0.153675186537546,26101,12385,6467,5736,101,26,0.522163907953169,0.463140896245458,731,0.059023011707711
MI,Marquette County,26103,16042,14646,32897,0.48764325014439,0.445207769705444,1396,0.042435480438946,26103,32144,18126,13609,103,26,0.563899950223992,0.423376057740169,4517,0.140523892483823
MI,Mason County,26105,5281,8505,14658,0.360281075180789,0.580229226361031,3224,-0.219948151180243,26105,14588,6856,7580,105,26,0.469975322182616,0.519605154921854,724,-0.049629832739238
MI,Mecosta County,26107,5827,10305,17149,0.339786576476763,0.600909674033471,4478,-0.261123097556709,26107,16879,7515,9175,107,26,0.445227797855323,0.543574856330351,1660,-0.098347058475028
MI,Menominee County,26109,3539,6704,10765,0.32875058058523,0.622758941012541,3165,-0.294008360427311,26109,10922,5244,5565,109,26,0.480131843984618,0.509522065555759,321,-0.029390221571141
MI,Midland County,26111,15655,23877,42379,0.369404657967389,0.563415842752307,8222,-0.194011184784917,26111,41808,17480,23942,111,26,0.418101798698814,0.572665518561041,6462,-0.154563719862227
MI,Missaukee County,26113,1565,5386,7301,0.214354198055061,0.737707163402274,3821,-0.523352965347213,26113,7024,2274,4665,113,26,0.32374715261959,0.664151480637813,2391,-0.340404328018223
MI,Monroe County,26115,26859,43255,74101,0.362464744065532,0.58373031403085,16396,-0.221265569965318,26115,72682,36310,35593,115,26,0.499573484494098,0.489708593599516,717,0.009864890894582
MI,Montcalm County,26117,7874,16907,26556,0.296505497815936,0.636654616659135,9033,-0.340149118843199,26117,25383,11431,13624,117,26,0.450340779261711,0.536737186305795,2193,-0.086396407044085
MI,Montmorency County,26119,1286,3498,5008,0.256789137380192,0.698482428115016,2212,-0.441693290734824,26119,5051,2049,2928,119,26,0.40566224509998,0.579687190655316,879,-0.174024945555336
MI,Muskegon County,26121,36640,35962,77114,0.475140700780662,0.466348522965998,678,0.008792177814664,26121,76054,44436,30882,121,26,0.584269071975176,0.406053593499356,13554,0.17821547847582
MI,Newaygo County,26123,6212,15174,22605,0.274806458748065,0.671267418712674,8962,-0.39646095996461,26123,21424,8723,12458,123,26,0.407160194174757,0.581497386109037,3735,-0.174337191934279
MI,Oakland County,26125,342976,289127,663255,0.517110312021771,0.435921327392933,53849,0.081188984628838,26125,650306,349055,296531,125,26,0.536755004567081,0.455986873871685,52524,0.080768130695396
MI,Oceana County,26127,3973,7228,11903,0.333781399647148,0.607241871797026,3255,-0.273460472149878,26127,11438,5063,6239,127,26,0.44264731596433,0.54546249344291,1176,-0.10281517747858
MI,Ogemaw County,26129,3030,6827,10386,0.291738879260543,0.657327171191989,3797,-0.365588291931446,26129,10361,4791,5437,129,26,0.462407103561432,0.524756297654667,646,-0.062349194093234
MI,Ontonagon County,26131,1175,2069,3420,0.343567251461988,0.604970760233918,894,-0.26140350877193,26131,3535,1585,1906,131,26,0.448373408769448,0.539179632248939,321,-0.090806223479491
MI,Osceola County,26133,2705,7336,10597,0.255260922902708,0.692271397565349,4631,-0.43701047466264,26133,10265,3981,6140,133,26,0.387822698490015,0.598149050170482,2159,-0.210326351680468
MI,Oscoda County,26135,1044,2843,4062,0.257016248153619,0.699901526341704,1799,-0.442885278188085,26135,4027,1654,2308,135,26,0.410727588775764,0.57313136329774,654,-0.162403774521977
MI,Otsego County,26137,3556,8266,12529,0.283821534041025,0.659749381435071,4710,-0.375927847394046,26137,11829,4681,7008,137,26,0.395722377208555,0.592442302815115,2327,-0.19671992560656
MI,Ottawa County,26139,46276,90456,145405,0.318255905917953,0.622096901757161,44180,-0.303840995839208,26139,132695,43068,88503,139,26,0.324563849429142,0.666965597799465,45435,-0.342401748370323
MI,Presque Isle County,26141,2400,4486,7215,0.332640332640333,0.621760221760222,2086,-0.289119889119889,26141,7077,3192,3794,141,26,0.451038575667656,0.536102868447082,602,-0.085064292779426
MI,Roscommon County,26143,4287,8141,13036,0.328858545566125,0.624501380791654,3854,-0.295642835225529,26143,13032,6198,6701,143,26,0.475598526703499,0.514195825659914,503,-0.038597298956415
MI,Saginaw County,26145,44395,45469,94198,0.47129450731438,0.482696023270133,1074,-0.011401515955753,26145,97903,54372,42716,145,26,0.555366025555907,0.436309408291881,11656,0.119056617264027
MI,St. Clair County,26147,24553,49067,77994,0.314806267148755,0.629112495833013,24514,-0.314306228684258,26147,73740,33845,39076,147,26,0.458977488473013,0.529915920802821,5231,-0.070938432329807
MI,St. Joseph County,26149,7529,14886,23765,0.316810435514412,0.626383336839891,7357,-0.309572901325479,26149,23314,10106,12975,149,26,0.433473449429527,0.556532555546024,2869,-0.123059106116497
MI,Sanilac County,26151,4873,13446,19243,0.253234942576521,0.698747596528608,8573,-0.445512653952086,26151,18359,7212,10961,151,26,0.392831853586797,0.597036875646822,3749,-0.204205022060025
MI,Schoolcraft County,26153,1369,2556,4151,0.329800048181161,0.615755239701277,1187,-0.285955191520116,26153,4046,1865,2142,153,26,0.46094908551656,0.529411764705882,277,-0.068462679189323
MI,Shiawassee County,26155,12547,19232,34044,0.368552461520385,0.564915991070379,6685,-0.196363529549994,26155,33590,17197,15962,155,26,0.511967847573683,0.475200952664483,1235,0.036766894909199
MI,Tuscola County,26157,7493,17421,26157,0.28646251481439,0.666016745039569,9928,-0.379554230225179,26157,26482,11643,14517,157,26,0.439657125594744,0.548183671928102,2874,-0.108526546333359
MI,Van Buren County,26159,13258,17890,33213,0.399181043567278,0.538644506669075,4632,-0.139463463101798,26159,32798,16288,16140,159,26,0.496615647295567,0.492103177022989,148,0.004512470272578
MI,Washtenaw County,26161,128025,50335,187201,0.683890577507599,0.268882110672486,77690,0.415008466835113,26161,179016,120791,56401,161,26,0.674749743039728,0.315061223577781,64390,0.359688519461948
MI,Wayne County,26163,517842,228908,775450,0.667795473595977,0.295193758462828,288934,0.372601715133149,26163,814108,595253,213586,163,26,0.731172031229272,0.26235585450579,381667,0.468816176723481
MI,Wexford County,26165,4436,10000,15279,0.290333136985405,0.654493095097847,5564,-0.364159958112442,26165,13859,5717,7972,165,26,0.412511725232701,0.575221877480338,2255,-0.162710152247637
MN,Aitkin County,27001,3134,5516,9185,0.341208492106696,0.600544365813827,2382,-0.259335873707131,27001,9109,4412,4533,1,27,0.484356131298716,0.497639697002964,121,-0.013283565704249
MN,Anoka County,27003,75499,93341,184084,0.410133417352948,0.507056561135134,17842,-0.096923143782187,27003,185714,88611,93430,3,27,0.477136887902905,0.503085389362137,4819,-0.025948501459233
MN,Becker County,27005,5208,10880,17090,0.304739613809245,0.63662960795787,5672,-0.331889994148625,27005,16329,6829,9204,5,27,0.418212995284463,0.563659746463347,2375,-0.145446751178884
MN,Beltrami County,27007,8688,10783,21316,0.40758115969225,0.505864139613436,2095,-0.098282979921186,27007,21949,11818,9637,7,27,0.538429996810789,0.439063283065288,2181,0.099366713745501
MN,Benton County,27009,5640,12872,19911,0.283260509266235,0.646476821857265,7232,-0.36321631259103,27009,19521,8173,10849,9,27,0.418677321858511,0.55576046309103,2676,-0.137083141232519
MN,Big Stone County,27011,921,1607,2729,0.337486258702822,0.588860388420667,686,-0.251374129717845,27011,2783,1345,1385,11,27,0.483291412145167,0.497664390945023,40,-0.014372978799856
MN,Blue Earth County,27013,14428,15667,33256,0.43384652393553,0.471102958864566,1239,-0.037256434929035,27013,34039,18164,14916,13,27,0.533623196921179,0.43820323746291,3248,0.095419959458269
MN,Brown County,27015,3763,8708,13663,0.275415355339237,0.637341725828881,4945,-0.361926370489644,27015,13882,5630,7938,15,27,0.405561158334534,0.571819622532776,2308,-0.166258464198242
MN,Carlton County,27017,8460,8160,18059,0.468464477545822,0.451852262030013,300,0.016612215515809,27017,18356,11389,6586,17,27,0.620451078666376,0.358792765308346,4803,0.26165831335803
MN,Carver County,27019,21508,29057,55102,0.390330659504192,0.527331131356394,7549,-0.137000471852201,27019,52747,20745,31155,19,27,0.393292509526608,0.590649705196504,10410,-0.197357195669896
MN,Cass County,27021,4949,9982,15885,0.311551778407303,0.628391564368902,5033,-0.316839785961599,27021,16080,6858,8957,21,27,0.426492537313433,0.55702736318408,2099,-0.130534825870647
MN,Chippewa County,27023,1978,3764,6182,0.319961177612423,0.608864445163378,1786,-0.288903267550954,27023,6176,3083,2967,23,27,0.499190414507772,0.480408031088083,116,0.018782383419689
MN,Chisago County,27025,9279,18441,30009,0.309207237828651,0.614515645306408,9162,-0.305308407477757,27025,29331,12524,16227,25,27,0.426988510449695,0.553237189321878,3703,-0.126248678872183
MN,Clay County,27027,12974,13549,29108,0.445719389858458,0.465473409371994,575,-0.019754019513536,27027,28771,15210,12920,27,27,0.528657328560008,0.4490632928991,2290,0.079594035660909
MN,Clearwater County,27029,1100,2925,4225,0.260355029585799,0.692307692307692,1825,-0.431952662721893,27029,4183,1753,2359,29,27,0.419077217308152,0.56394931867081,606,-0.144872101362658
MN,Cook County,27031,1912,1156,3360,0.569047619047619,0.344047619047619,756,0.225,27031,3304,1993,1221,31,27,0.603208232445521,0.36955205811138,772,0.23365617433414
MN,Cottonwood County,27033,1678,3679,5697,0.294540986484114,0.645778479901703,2001,-0.351237493417588,27033,5848,2433,3316,33,27,0.416039671682627,0.56703146374829,883,-0.150991792065663
MN,Crow Wing County,27035,10982,22287,35568,0.308760683760684,0.626602564102564,11305,-0.31784188034188,27035,34800,14760,19415,35,27,0.424137931034483,0.557902298850575,4655,-0.133764367816092
MN,Dakota County,27037,110251,99624,228659,0.482163396148851,0.435688077005497,10627,0.046475319143353,27037,230023,116252,109514,37,27,0.505392938966973,0.47610021606535,6738,0.029292722901623
MN,Dodge County,27039,3102,6527,10564,0.293638773191973,0.617853085952291,3425,-0.324214312760318,27039,10272,4487,5522,39,27,0.436818535825545,0.537577881619938,1035,-0.100759345794393
MN,Douglas County,27041,6227,13966,21623,0.287980391250058,0.645886324746797,7739,-0.35790593349674,27041,20917,8665,11905,41,27,0.414256346512406,0.569154276425874,3240,-0.154897929913467
MN,Faribault County,27043,2153,4659,7355,0.292726036709721,0.633446634942216,2506,-0.340720598232495,27043,7689,3407,4104,43,27,0.443100533229289,0.533749512290285,697,-0.090648979060996
MN,Fillmore County,27045,3872,6271,10976,0.352769679300292,0.571337463556851,2399,-0.21856778425656,27045,10854,5713,4913,45,27,0.526349732817395,0.452644186475032,800,0.073705546342362
MN,Freeborn County,27047,6041,8808,15929,0.379245401469019,0.552953732186578,2767,-0.173708330717559,27047,16645,9327,6970,47,27,0.560348452988886,0.418744367677981,2357,0.141604085310904
MN,Goodhue County,27049,9446,14041,25538,0.369880178557444,0.549808129062573,4595,-0.17992795050513,27049,25701,12212,12986,49,27,0.475156608692269,0.505272168398117,774,-0.030115559705848
MN,Grant County,27051,1104,2063,3453,0.319721980886186,0.597451491456704,959,-0.277729510570518,27051,3471,1647,1748,51,27,0.474503025064823,0.503601267646211,101,-0.029098242581389
MN,Hennepin County,27053,429283,191768,672644,0.638202377483483,0.285095830781216,237515,0.353106546702267,27053,677965,423979,240073,53,27,0.625370041226317,0.354108250425907,183906,0.27126179080041
MN,Houston County,27055,4145,5616,10515,0.394198763670946,0.534094151212553,1471,-0.139895387541607,27055,10422,5281,4951,55,27,0.506716561120706,0.475052772980234,330,0.031663788140472
MN,Hubbard County,27057,3432,7269,11423,0.300446467652981,0.636347719513263,3837,-0.335901251860282,27057,11482,4676,6622,57,27,0.407246124368577,0.576728792893224,1946,-0.169482668524647
MN,Isanti County,27059,5656,13635,20875,0.270946107784431,0.653173652694611,7979,-0.38222754491018,27059,20131,8024,11675,59,27,0.398589240474889,0.579951318861457,3651,-0.181362078386568
MN,Itasca County,27061,9015,12920,23650,0.381183932346723,0.54630021141649,3905,-0.165116279069767,27061,23833,12852,10500,61,27,0.539252297234926,0.440565602316116,2352,0.09868669491881
MN,Jackson County,27063,1492,3609,5453,0.273610856409316,0.661837520630845,2117,-0.38822666422153,27063,5415,2268,3044,63,27,0.418836565096953,0.562142197599261,776,-0.143305632502308
MN,Kanabec County,27065,2327,5230,8125,0.2864,0.643692307692308,2903,-0.357292307692308,27065,8107,3586,4319,65,27,0.442333785617368,0.532749475761687,733,-0.09041569014432
MN,Kandiyohi County,27067,7266,12785,21648,0.335643015521064,0.590585735402809,5519,-0.254942719881744,27067,21403,9806,11239,67,27,0.458160071018082,0.525113301873569,1433,-0.066953230855488
MN,Kittson County,27069,823,1349,2363,0.348286077020736,0.570884468895472,526,-0.222598391874735,27069,2405,1241,1095,69,27,0.516008316008316,0.455301455301455,146,0.060706860706861
MN,Koochiching County,27071,2306,3569,6313,0.365277997782354,0.565341359100269,1263,-0.200063361317915,27071,6432,3451,2841,71,27,0.536536069651741,0.44169776119403,610,0.094838308457711
MN,Lac qui Parle County,27073,1301,2294,3835,0.339243807040417,0.598174706649283,993,-0.258930899608866,27073,3974,1974,1938,73,27,0.496728736789129,0.487669854051334,36,0.009058882737796
MN,Lake County,27075,3077,2932,6472,0.475432632880099,0.453028430160692,145,0.022404202719407,27075,6797,4043,2610,75,27,0.594821244666765,0.383992938060909,1433,0.210828306605856
MN,Lake of the Woods County,27077,553,1540,2230,0.247982062780269,0.690582959641256,987,-0.442600896860987,27077,2220,859,1306,77,27,0.386936936936937,0.588288288288288,447,-0.201351351351351
MN,Le Sueur County,27079,4623,9182,14867,0.310957153427053,0.617609470639672,4559,-0.306652317212619,27079,14730,6753,7714,79,27,0.458452138492872,0.523693143245078,961,-0.065241004752206
MN,Lincoln County,27081,860,1930,3002,0.286475682878081,0.64290473017988,1070,-0.356429047301799,27081,3113,1428,1594,81,27,0.458721490523611,0.512046257629296,166,-0.053324767105686
MN,Lyon County,27083,3825,7256,12129,0.31535988127628,0.598235633605408,3431,-0.282875752329129,27083,12334,5465,6595,83,27,0.443084157613102,0.534700826982325,1130,-0.091616669369223
MN,McLeod County,27085,4978,12155,18684,0.266431171055448,0.650556625990152,7177,-0.384125454934703,27085,18455,6970,11069,85,27,0.377675426713628,0.599783256570035,4099,-0.222107829856407
MN,Mahnomen County,27087,930,991,2074,0.448408871745419,0.477820636451302,61,-0.029411764705882,27087,2179,1276,871,87,27,0.585589720055071,0.399724644332262,405,0.185865075722809
MN,Marshall County,27089,1225,3208,4794,0.255527743012098,0.669169795577806,1983,-0.413642052565707,27089,4335,1854,2380,89,27,0.427681660899654,0.549019607843137,526,-0.121337946943483
MN,Martin County,27091,2733,7062,10469,0.261056452383227,0.674562995510555,4329,-0.413506543127328,27091,10927,4054,6657,91,27,0.371007595863457,0.609224855861627,2603,-0.23821725999817
MN,Meeker County,27093,3192,8103,12198,0.261682242990654,0.664289227742253,4911,-0.402606984751599,27093,12167,4969,6913,93,27,0.408399769869319,0.568176214350292,1944,-0.159776444480973
MN,Mille Lacs County,27095,3709,8340,12948,0.286453506333024,0.644114921223355,4631,-0.357661414890331,27095,13047,5829,6951,95,27,0.446769372269487,0.532766153138653,1122,-0.085996780869165
MN,Morrison County,27097,3637,12925,17534,0.207425573172123,0.737139272271016,9288,-0.529713699098894,27097,16662,6153,10159,97,27,0.369283399351819,0.60971071900132,4006,-0.240427319649502
MN,Mower County,27099,7444,8826,17587,0.423267185989652,0.5018479558765,1382,-0.078580769886848,27099,18471,11129,6938,99,27,0.602512045909805,0.375615830220345,4191,0.226896215689459
MN,Murray County,27101,1295,2974,4642,0.278974579922447,0.640672124084446,1679,-0.361697544161999,27101,4754,2160,2504,101,27,0.454354228018511,0.526714345814051,344,-0.072360117795541
MN,Nicollet County,27103,7886,8436,17914,0.440214357485765,0.470916601540694,550,-0.030702244054929,27103,18285,9652,8214,103,27,0.527864369701941,0.449220672682527,1438,0.078643697019415
MN,Nobles County,27105,2733,5299,8592,0.318086592178771,0.616736499068901,2566,-0.29864990689013,27105,8493,3793,4581,105,27,0.446603084893442,0.539385376192158,788,-0.092782291298717
MN,Norman County,27107,1264,1699,3232,0.391089108910891,0.525680693069307,435,-0.134591584158416,27107,3199,1730,1384,107,27,0.540793998124414,0.432635198499531,346,0.108158799624883
MN,Olmsted County,27109,36266,35668,79277,0.457459288318175,0.449916116906543,598,0.007543171411633,27109,77951,39338,36832,109,27,0.504650357275725,0.472501956357199,2506,0.032148400918526
MN,Otter Tail County,27111,9339,20939,32284,0.289276421756907,0.64858753562136,11600,-0.359311113864453,27111,31562,12165,18860,111,27,0.385431848425322,0.597554020657753,6695,-0.212122172232431
MN,Pennington County,27113,2146,4000,6671,0.321690900914406,0.599610253335332,1854,-0.277919352420926,27113,6493,3024,3304,113,27,0.465732327121515,0.508855690743878,280,-0.043123363622363
MN,Pine County,27115,4580,8191,13729,0.333600407895695,0.596620292810838,3611,-0.263019884915143,27115,13904,6750,6845,115,27,0.485471806674338,0.492304372842348,95,-0.006832566168009
MN,Pipestone County,27117,1127,3338,4779,0.235823394015484,0.698472483783218,2211,-0.462649089767734,27117,4637,1728,2828,117,27,0.372654733664007,0.609877075695493,1100,-0.237222342031486
MN,Polk County,27119,4712,8979,14698,0.320587835079603,0.610899442100966,4267,-0.290311607021363,27119,14644,6773,7615,119,27,0.462510243102977,0.520008194482382,842,-0.057497951379405
MN,Pope County,27121,2106,3793,6294,0.334604385128694,0.602637432475373,1687,-0.268033047346679,27121,6224,2981,3142,121,27,0.478952442159383,0.504820051413882,161,-0.025867609254499
MN,Ramsey County,27123,176929,70778,269161,0.65733520086491,0.262957857936328,106151,0.394377342928582,27123,277782,184936,86799,123,27,0.665759480455897,0.312471650430913,98137,0.353287830024984
MN,Red Lake County,27125,540,1141,1871,0.288615713522181,0.609834313201497,601,-0.321218599679316,27125,1963,928,978,125,27,0.472745797249109,0.498217014773306,50,-0.025471217524198
MN,Redwood County,27127,1887,5137,7566,0.249405233941316,0.678958498546127,3250,-0.429553264604811,27127,7761,3008,4570,127,27,0.387578920242237,0.588841644118026,1562,-0.201262723875789
MN,Renville County,27129,2117,4890,7563,0.279915377495703,0.646568821896073,2773,-0.36665344440037,27129,7684,3394,4149,129,27,0.441697032795419,0.539953149401353,755,-0.098256116605934
MN,Rice County,27131,14437,15429,32217,0.448117453518329,0.478908650712357,992,-0.030791197194028,27131,32160,17054,14380,131,27,0.530286069651741,0.447139303482587,2674,0.083146766169154
MN,Rock County,27133,1373,3091,4807,0.285625130018723,0.643020594965675,1718,-0.357395464946952,27133,4830,1945,2810,133,27,0.402691511387164,0.581780538302277,865,-0.179089026915114
MN,Roseau County,27135,1856,5451,7767,0.238959701300373,0.701815372730784,3595,-0.462855671430411,27135,7330,2772,4409,135,27,0.378171896316507,0.60150068212824,1637,-0.223328785811733
MN,St. Louis County,27137,57769,44631,111260,0.519225238180838,0.401141470429624,13138,0.118083767751213,27137,116460,74177,39675,137,27,0.636931135153701,0.340674909840288,34502,0.296256225313412
MN,Scott County,27139,28502,39948,74390,0.383142895550477,0.537007662320204,11446,-0.153864766769727,27139,71411,29714,40321,139,27,0.416098360196608,0.564632899693325,10607,-0.148534539496716
MN,Sherburne County,27141,13299,31049,47938,0.277420835245525,0.64769076724102,17750,-0.370269931995494,27141,46320,17597,27848,141,27,0.379900690846287,0.601208981001727,10251,-0.22130829015544
MN,Sibley County,27143,1954,5193,7727,0.25287951339459,0.672059013847548,3239,-0.419179500452957,27143,7785,2916,4693,143,27,0.374566473988439,0.602825947334618,1777,-0.228259473346178
MN,Stearns County,27145,25575,47618,78985,0.323795657403304,0.602873963410774,22043,-0.27907830600747,27145,78178,33552,43015,145,27,0.42917444805444,0.550218731612474,9463,-0.121044283558034
MN,Steele County,27147,6239,11198,19040,0.327678571428571,0.58813025210084,4959,-0.260451680672269,27147,19034,8706,9903,147,27,0.457392035305243,0.520279499842387,1197,-0.062887464537144
MN,Stevens County,27149,2116,2800,5350,0.395514018691589,0.523364485981308,684,-0.12785046728972,27149,5621,2742,2766,149,27,0.487813556306707,0.492083259206547,24,-0.00426970289984
MN,Swift County,27151,1679,2962,4968,0.337962962962963,0.59621578099839,1283,-0.258252818035427,27151,5087,2751,2248,151,27,0.540790249655986,0.441910752899548,503,0.098879496756438
MN,Todd County,27153,2783,8485,11944,0.233004018754186,0.710398526456798,5702,-0.477394507702612,27153,11762,4819,6719,153,27,0.409709233123619,0.571246386668934,1900,-0.161537153545315
MN,Traverse County,27155,631,1050,1791,0.352317141261865,0.586264656616415,419,-0.23394751535455,27155,1840,942,860,155,27,0.51195652173913,0.467391304347826,82,0.044565217391304
MN,Wabasha County,27157,3866,6989,11764,0.328629717783067,0.594100646038762,3123,-0.265470928255695,27157,11722,5415,6049,157,27,0.461951885343798,0.516038218734004,634,-0.054086333390207
MN,Wadena County,27159,1684,4837,6894,0.244270380040615,0.701624601102408,3153,-0.457354221061793,27159,6772,2492,4143,159,27,0.367985823981099,0.611783815711754,1651,-0.243797991730656
MN,Waseca County,27161,2838,5967,9579,0.296273097400564,0.622925148762919,3129,-0.326652051362355,27161,9706,4370,5116,161,27,0.450236966824645,0.527096641252833,746,-0.076859674428189
MN,Washington County,27163,67086,64429,142843,0.469648495201025,0.451047653717718,2657,0.018600841483307,27163,141711,70203,69137,163,27,0.495395558566378,0.487873206737656,1066,0.007522351828722
MN,Watonwan County,27165,1814,2768,4971,0.364916515791591,0.556829611748139,954,-0.191913095956548,27165,5115,2494,2517,165,27,0.487585532746823,0.49208211143695,23,-0.004496578690127
MN,Wilkin County,27167,893,2129,3279,0.272339127782861,0.649283318084782,1236,-0.376944190301921,27167,3212,1258,1884,167,27,0.391656288916563,0.586550435865504,626,-0.194894146948942
MN,Winona County,27169,11366,12122,25852,0.43965650626644,0.468899891691165,756,-0.029243385424725,27169,27103,14980,11480,169,27,0.552706342471313,0.423569346566801,3500,0.129136995904512
MN,Wright County,27171,20336,43274,69154,0.294068311305203,0.625762790294126,22938,-0.331694478988923,27171,69550,26584,41460,171,27,0.382228612508986,0.596117900790798,14876,-0.213889288281812
MN,Yellow Medicine County,27173,1524,3382,5253,0.290119931467733,0.643822577574719,1858,-0.353702646106986,27173,5397,2465,2806,173,27,0.456735223272188,0.519918473225866,341,-0.063183249953678
MS,Adams County,28001,6921,5125,12214,0.566644833797282,0.419600458490257,1796,0.147044375307025,28001,13621,7999,5542,1,28,0.587254973937303,0.406871742162837,2457,0.180383231774466
MS,Alcorn County,28003,2684,11817,14781,0.181584466544889,0.799472295514512,9133,-0.617887828969623,28003,14682,3449,11027,3,28,0.234913499523226,0.751055714480316,7578,-0.51614221495709
MS,Amite County,28005,2688,4282,7033,0.382198208445898,0.608844021043651,1594,-0.226645812597753,28005,7661,3218,4393,5,28,0.42004960187965,0.573423835008484,1175,-0.153374233128834
MS,Attala County,28007,2847,4288,7242,0.393123446561723,0.592101629384148,1441,-0.198978182822425,28007,7853,3368,4452,7,28,0.428880682541704,0.566917101744556,1084,-0.138036419202852
MS,Benton County,28009,1713,2240,3996,0.428678678678679,0.560560560560561,527,-0.131881881881882,28009,4080,2026,2030,9,28,0.49656862745098,0.497549019607843,4,-0.000980392156863
MS,Bolivar County,28011,8410,4251,12831,0.655443846933209,0.331306990881459,4159,0.32413685605175,28011,14258,9772,4346,11,28,0.685369617057091,0.304811333987937,5426,0.380558283069154
MS,Calhoun County,28013,1884,4360,6339,0.297207761476574,0.687805647578482,2476,-0.390597886101909,28013,6273,2250,3961,13,28,0.358680057388809,0.631436314363144,1711,-0.272756256974334
MS,Carroll County,28015,1648,3774,5470,0.30127970749543,0.689945155393053,2126,-0.388665447897623,28015,5968,1990,3953,15,28,0.333445040214477,0.662365951742627,1963,-0.32892091152815
MS,Chickasaw County,28017,3649,4127,7890,0.462484157160963,0.523067173637516,478,-0.060583016476553,28017,7641,3914,3601,17,28,0.512236618243685,0.471273393534878,313,0.040963224708808
MS,Choctaw County,28019,1198,2763,4020,0.298009950248756,0.687313432835821,1565,-0.389303482587065,28019,3847,1283,2533,19,28,0.333506628541721,0.658435144268261,1250,-0.32492851572654
MS,Claiborne County,28021,2523,414,2954,0.854096140825999,0.140148950575491,2109,0.713947190250508,28021,5258,4633,608,21,28,0.881133510840624,0.115633320654241,4025,0.765500190186383
MS,Clarke County,28023,2556,5088,7713,0.331388564760793,0.659665499805523,2532,-0.32827693504473,28023,7199,2695,4415,23,28,0.374357549659675,0.613279622169746,1720,-0.238922072510071
MS,Clay County,28025,5695,4136,9960,0.571787148594378,0.415261044176707,1559,0.156526104417671,28025,9659,5860,3735,25,28,0.606688062946475,0.386685992338751,2125,0.220002070607723
MS,Coahoma County,28027,6378,2426,8912,0.715664272890485,0.27221723518851,3952,0.443447037701975,28027,9563,7164,2356,27,28,0.749137300010457,0.246366203074349,4808,0.502771096936108
MS,Copiah County,28029,6203,5576,11906,0.520997816227112,0.468335293129515,627,0.052662523097598,28029,13002,7201,5714,29,28,0.553837871096754,0.439470850638363,1487,0.114367020458391
MS,Covington County,28031,3267,5423,8790,0.371672354948806,0.616951080773606,2156,-0.245278725824801,28031,9145,3800,5282,31,28,0.415527610716238,0.577583378895571,1482,-0.162055768179333
MS,DeSoto County,28033,19892,42155,64022,0.310705694917372,0.658445534347568,22263,-0.347739839430196,28033,64026,20979,42399,33,28,0.327663761596851,0.662215350014057,21420,-0.334551588417205
MS,Forrest County,28035,11271,15149,27284,0.413099252309046,0.555233836680839,3878,-0.142134584371793,28035,27789,12079,15339,35,28,0.434668393968837,0.551980999676131,3260,-0.117312605707294
MS,Franklin County,28037,1471,2685,4219,0.34866082009955,0.636406731452951,1214,-0.287745911353401,28037,4443,1706,2705,37,28,0.383974791807337,0.608822867431915,999,-0.224848075624578
MS,George County,28039,1013,8652,9831,0.103041399654155,0.880073237717424,7639,-0.777031838063269,28039,9826,1352,8353,39,28,0.137594138001221,0.850091593730918,7001,-0.712497455729697
MS,Greene County,28041,956,4309,5325,0.179530516431925,0.809201877934272,3353,-0.629671361502347,28041,5919,1325,4528,41,28,0.223855380976516,0.764994086838993,3203,-0.541138705862477
MS,Grenada County,28043,4386,5940,10442,0.420034476153993,0.568856540892549,1554,-0.148822064738556,28043,11320,5279,5980,43,28,0.466342756183746,0.528268551236749,701,-0.061925795053004
MS,Hancock County,28045,3320,13720,17517,0.189530170691328,0.783239139121996,10400,-0.593708968430667,28045,17023,3879,12859,45,28,0.227868178346942,0.755389766786113,8980,-0.527521588439171
MS,Harrison County,28047,20679,39710,62076,0.333123912623236,0.639699722920291,19031,-0.306575810297055,28047,61602,22242,38646,47,28,0.361059705853706,0.627349761371384,16404,-0.266290055517678
MS,Hinds County,28049,64922,24919,91536,0.709251005069044,0.27223169026394,40003,0.437019314805104,28049,97639,70512,26450,49,28,0.722170444187261,0.270895851043128,44062,0.451274593144133
MS,Holmes County,28051,5820,1151,7045,0.826117814052519,0.163378282469837,4669,0.662739531582683,28051,8076,6775,1264,51,28,0.838905398712234,0.156513125309559,5511,0.682392273402675
MS,Humphreys County,28053,2652,924,3599,0.736871353153654,0.256737982772992,1728,0.480133370380661,28053,4481,3399,1069,53,28,0.758536041062263,0.238562820798929,2330,0.519973220263334
MS,Issaquena County,28055,395,298,699,0.565092989985694,0.426323319027182,97,0.138769670958512,28055,787,479,302,55,28,0.60864040660737,0.383735705209657,177,0.224904701397713
MS,Itawamba County,28057,1100,8385,9634,0.114178949553664,0.870354992734067,7285,-0.756176043180403,28057,8729,1599,6925,57,28,0.183182495131172,0.793332569595601,5326,-0.610150074464429
MS,Jackson County,28059,13087,31204,45465,0.287847795007148,0.686330144066865,18117,-0.398482349059716,28059,49290,15452,33262,59,28,0.31349158044228,0.674822479204707,17810,-0.361330898762426
MS,Jasper County,28061,4367,4032,8468,0.51570618800189,0.476145488899386,335,0.039560699102504,28061,9340,5097,4193,61,28,0.545717344753747,0.448929336188437,904,0.096788008565311
MS,Jefferson County,28063,3337,489,3859,0.864731795802021,0.126716766001555,2848,0.738015029800466,28063,3953,3508,431,63,28,0.887427270427523,0.109031115608399,3077,0.778396154819125
MS,Jefferson Davis County,28065,3720,2466,6237,0.596440596440596,0.395382395382395,1254,0.201058201058201,28065,6618,4094,2439,65,28,0.6186158960411,0.368540344514959,1655,0.250075551526141
MS,Jones County,28067,7748,20076,28250,0.274265486725664,0.710654867256637,12328,-0.436389380530973,28067,30038,9146,20635,67,28,0.304480990745056,0.686963179972035,11489,-0.382482189226979
MS,Kemper County,28069,2827,1778,4639,0.609398577279586,0.383272256951929,1049,0.226126320327657,28069,5052,3239,1789,69,28,0.641132224861441,0.354117181314331,1450,0.28701504354711
MS,Lafayette County,28071,7968,10872,19642,0.405661337949292,0.553507789430812,2904,-0.147846451481519,28071,17191,7098,9772,71,28,0.412890465941481,0.568436972834623,2674,-0.155546506893142
MS,Lamar County,28073,5044,18493,24179,0.208610777947806,0.764837255469622,13449,-0.556226477521817,28073,22780,5037,17472,73,28,0.221115013169447,0.766988586479368,12435,-0.545873573309921
MS,Lauderdale County,28075,10910,17574,28967,0.376635481755101,0.606690371802396,6664,-0.230054890047295,28075,30213,12642,17322,75,28,0.418429153013603,0.573329361533115,4680,-0.154900208519512
MS,Lawrence County,28077,2181,4072,6329,0.344604202875652,0.643387580976458,1891,-0.298783378100806,28077,6584,2394,4153,77,28,0.363608748481166,0.630771567436209,1759,-0.267162818955042
MS,Leake County,28079,3579,4775,8436,0.42425320056899,0.566026552868658,1196,-0.141773352299668,28079,7921,3599,4283,79,28,0.454361823002146,0.540714556242899,684,-0.086352733240753
MS,Lee County,28081,9635,21695,31974,0.301338587602427,0.678520047538625,12060,-0.377181459936198,28081,34363,12043,22004,81,28,0.350464162034747,0.640339900474347,9961,-0.289875738439601
MS,Leflore County,28083,6677,2757,9566,0.697992891490696,0.28820823750784,3920,0.409784653982856,28083,11600,8423,3115,83,28,0.726120689655172,0.268534482758621,5308,0.457586206896552
MS,Lincoln County,28085,4458,10550,15193,0.293424603435793,0.69439873626012,6092,-0.400974132824327,28085,14303,4879,9333,85,28,0.341117248129763,0.652520450255191,4454,-0.311403202125428
MS,Lowndes County,28087,11545,13124,25139,0.459246588965353,0.522057361072437,1579,-0.062810772107085,28087,24674,12037,12399,87,28,0.487841452541136,0.502512766474832,362,-0.014671313933695
MS,Madison County,28089,18358,25607,45048,0.407520866631149,0.568438110459954,7249,-0.160917243828805,28089,49571,20722,28507,89,28,0.418026668818462,0.575074136087632,7785,-0.15704746726917
MS,Marion County,28091,3572,7697,11443,0.312155903172245,0.672638294153631,4125,-0.360482390981386,28091,11041,3833,7118,91,28,0.3471605832805,0.644687981161127,3285,-0.297527397880627
MS,Marshall County,28093,7944,6525,14698,0.54048169819023,0.443937950741598,1419,0.096543747448633,28093,16141,9581,6444,93,28,0.593581562480639,0.39923177002664,3137,0.194349792453999
MS,Monroe County,28095,5485,10107,15781,0.347569862492871,0.640453710157785,4622,-0.292883847664913,28095,16789,6990,9661,95,28,0.416344034784681,0.575436297575794,2671,-0.159092262791113
MS,Montgomery County,28097,1775,2334,4162,0.42647765497357,0.560788082652571,559,-0.134310427679,28097,4807,2245,2543,97,28,0.467027251924277,0.529020178905762,298,-0.061992926981485
MS,Neshoba County,28099,2668,7613,10438,0.255604521939069,0.729354282429584,4945,-0.473749760490515,28099,10890,3030,7772,99,28,0.278236914600551,0.713682277318641,4742,-0.43544536271809
MS,Newton County,28101,2549,5929,8594,0.296602280660926,0.689899930183849,3380,-0.393297649522923,28101,9039,3069,5909,101,28,0.339528708927979,0.65372275694214,2840,-0.314194048014161
MS,Noxubee County,28103,4330,1181,5538,0.781870711448176,0.213253882267967,3149,0.568616829180209,28103,6264,4920,1325,103,28,0.78544061302682,0.211526181353768,3595,0.573914431673052
MS,Oktibbeha County,28105,7851,7671,16151,0.486099931892762,0.474955111138629,180,0.011144820754133,28105,16001,8030,7728,105,28,0.501843634772827,0.482969814386601,302,0.018873820386226
MS,Panola County,28107,7300,7371,14854,0.491450114447287,0.496229971724788,71,-0.004779857277501,28107,16826,9079,7629,107,28,0.539581599904909,0.453405443955783,1450,0.086176155949126
MS,Pearl River County,28109,2919,15530,18893,0.154501667284179,0.821997565235801,12611,-0.667495897951622,28109,19938,3813,15836,109,28,0.191242852843816,0.794262212859866,12023,-0.60301936001605
MS,Perry County,28111,1220,4135,5432,0.22459499263623,0.761229749631811,2915,-0.536634756995582,28111,5686,1519,4110,111,28,0.267147379528667,0.722827998593036,2591,-0.455680619064369
MS,Pike County,28113,7636,7748,15633,0.488453911597262,0.495618243459349,112,-0.007164331862087,28113,17429,9304,7986,113,28,0.533822938780194,0.458201847495553,1318,0.075621091284641
MS,Pontotoc County,28115,2123,9442,11811,0.179747692828719,0.799424265515198,7319,-0.619676572686479,28115,12348,2785,9403,115,28,0.225542597991578,0.76149983803045,6618,-0.535957240038873
MS,Prentiss County,28117,2067,7647,9871,0.209401276466417,0.774693546753115,5580,-0.565292270286698,28117,10033,2817,7075,117,28,0.280773447622845,0.7051729293332,4258,-0.424399481710356
MS,Quitman County,28119,2303,998,3353,0.686847599164927,0.297643900984193,1305,0.389203698180734,28119,3979,2837,1116,119,28,0.712993214375471,0.280472480522744,1721,0.432520733852727
MS,Rankin County,28121,13741,46168,61356,0.223955277397484,0.752461047004368,32427,-0.528505769606884,28121,61438,14425,46318,121,28,0.234789543930466,0.753898238874963,31893,-0.519108694944497
MS,Scott County,28123,3999,5742,9867,0.405290361812101,0.581939799331104,1743,-0.176649437519003,28123,10584,4774,5728,123,28,0.451058201058201,0.54119425547997,954,-0.090136054421769
MS,Sharkey County,28125,1290,619,1926,0.669781931464174,0.321391484942887,671,0.348390446521288,28125,2258,1571,675,125,28,0.695748449955713,0.298937112488928,896,0.396811337466785
MS,Simpson County,28127,3871,7393,11416,0.339085494043448,0.64759985984583,3522,-0.308514365802383,28127,12249,4723,7424,127,28,0.385582496530329,0.60609029308515,2701,-0.220507796554821
MS,Smith County,28129,1598,5877,7556,0.21148755955532,0.77779248279513,4279,-0.566304923239809,28129,8099,1979,6049,129,28,0.244351154463514,0.746882331151994,4070,-0.50253117668848
MS,Stone County,28131,1400,4810,6368,0.219849246231156,0.755339195979899,3410,-0.535489949748744,28131,6820,1794,4924,131,28,0.263049853372434,0.721994134897361,3130,-0.458944281524927
MS,Sunflower County,28133,6560,2768,9406,0.697427174144163,0.294280246651074,3792,0.40314692749309,28133,10995,7989,2907,133,28,0.726603001364256,0.264392905866303,5082,0.462210095497954
MS,Tallahatchie County,28135,3337,2462,5870,0.568483816013629,0.419420783645656,875,0.149063032367973,28135,6363,3838,2480,135,28,0.603174603174603,0.38975326104039,1358,0.213421342134213
MS,Tate County,28137,3804,7385,11389,0.334006497497585,0.648432698217578,3581,-0.314426200719993,28137,11374,4572,6666,137,28,0.40196940390364,0.586073500967118,2094,-0.184104097063478
MS,Tippah County,28139,1808,7182,9143,0.197746910204528,0.785518976265996,5374,-0.587772066061468,28139,9008,2254,6625,139,28,0.250222024866785,0.735457371225577,4371,-0.485235346358792
MS,Tishomingo County,28141,990,7117,8310,0.11913357400722,0.856438026474128,6127,-0.737304452466907,28141,7850,1623,6070,141,28,0.206751592356688,0.773248407643312,4447,-0.566496815286624
MS,Tunica County,28143,2577,840,3463,0.744152468957551,0.242564250649726,1737,0.501588218307826,28143,4262,3371,867,143,28,0.790943219145941,0.203425621773815,2504,0.587517597372126
MS,Union County,28145,1969,9161,11374,0.173114119922631,0.805433444698435,7192,-0.632319324775804,28145,10359,2481,7759,145,28,0.239501882421083,0.749010522251183,5278,-0.509508639830099
MS,Walthall County,28147,2475,3374,5909,0.418852597732273,0.57099339989846,899,-0.152140802166187,28147,7476,3386,4012,147,28,0.452915997859818,0.536650615302301,626,-0.083734617442483
MS,Warren County,28149,8518,9420,18287,0.465795373762782,0.515120030622847,902,-0.049324656860065,28149,19429,9899,9390,149,28,0.509496114056308,0.483298162540532,509,0.026197951515775
MS,Washington County,28151,9847,4541,14571,0.675794386109395,0.311646420973166,5306,0.364147965136229,28151,17137,12188,4870,151,28,0.711209663301628,0.284180428313007,7318,0.427029234988621
MS,Wayne County,28153,3493,5957,9534,0.366372980910426,0.624816446402349,2464,-0.258443465491924,28153,10269,4116,6080,153,28,0.40081799591002,0.59207323011004,1964,-0.191255234200019
MS,Webster County,28155,1001,3949,5024,0.199243630573248,0.786027070063694,2948,-0.586783439490446,28155,4820,1087,3684,155,28,0.22551867219917,0.764315352697095,2597,-0.538796680497925
MS,Wilkinson County,28157,2826,1305,4174,0.677048394825108,0.312649736463824,1521,0.364398658361284,28157,4238,2940,1275,157,28,0.693723454459651,0.300849457291175,1665,0.392873997168476
MS,Winston County,28159,3778,4874,8771,0.430737658191768,0.555694903659788,1096,-0.12495724546802,28159,9758,4557,5147,159,28,0.46700143472023,0.527464644394343,590,-0.060463209674114
MS,Yalobusha County,28161,2574,3366,6058,0.424892703862661,0.555628920435787,792,-0.130736216573126,28161,6293,2984,3261,161,28,0.474177657714921,0.518194819640871,277,-0.04401716192595
MS,Yazoo County,28163,5221,4568,9892,0.527800242620299,0.461787302871007,653,0.066012939749292,28163,10853,6220,4560,163,28,0.573113424859486,0.420160324334286,1660,0.1529531005252
MO,Adair County,29001,3495,6019,10137,0.344776561112755,0.593765413830522,2524,-0.248988852717767,29001,10121,4218,5648,1,29,0.416757237427132,0.558047623752594,1430,-0.141290386325462
MO,Andrew County,29003,2045,6665,9140,0.223741794310722,0.729212253829322,4620,-0.5054704595186,29003,8306,2649,5457,3,29,0.318926077534313,0.656994943414399,2808,-0.338068865880087
MO,Atchison County,29005,541,2059,2723,0.19867792875505,0.756151303709144,1518,-0.557473374954095,29005,2709,756,1902,5,29,0.279069767441861,0.702104097452935,1146,-0.423034330011074
MO,Audrain County,29007,2567,6981,10043,0.255600916060938,0.695111022602808,4414,-0.43951010654187,29007,9951,3538,6186,7,29,0.355542156567179,0.621646065722038,2648,-0.266103909154859
MO,Barry County,29009,2710,11427,14604,0.185565598466174,0.782456861133936,8717,-0.596891262667762,29009,13806,3667,9832,9,29,0.265609155439664,0.712154135882949,6165,-0.446544980443286
MO,Barton County,29011,795,4958,5932,0.134018880647337,0.835805799055968,4163,-0.701786918408631,29011,5746,1232,4416,11,29,0.214410024364775,0.768534632788026,3184,-0.554124608423251
MO,Bates County,29013,1617,6000,8021,0.201595810996135,0.748036404438349,4383,-0.546440593442214,29013,7771,2557,5020,13,29,0.329043881096384,0.645991506884571,2463,-0.316947625788187
MO,Benton County,29015,2024,7212,9584,0.21118530884808,0.752504173622704,5188,-0.541318864774624,29015,9157,2925,6069,15,29,0.319427760183466,0.662771650103746,3144,-0.34334388992028
MO,Bollinger County,29017,705,4827,5669,0.124360557417534,0.851472922914094,4122,-0.72711236549656,29017,5455,1213,4094,17,29,0.222364802933089,0.750504124656279,2881,-0.52813932172319
MO,Boone County,29019,41072,36146,83312,0.492990205492606,0.43386306894565,4926,0.059127136546956,29019,79296,39782,37343,19,29,0.5016898708636,0.470931698950767,2439,0.030758171912833
MO,Buchanan County,29021,12010,21315,35563,0.337710541855299,0.599358884233614,9305,-0.261648342378315,29021,35106,15594,18660,21,29,0.444197573064433,0.531533071269868,3066,-0.087335498205435
MO,Butler County,29023,3036,13647,17232,0.176183844011142,0.791956824512535,10611,-0.615772980501393,29023,16889,4363,12248,23,29,0.25833382675114,0.725205755225295,7885,-0.466871928474155
MO,Caldwell County,29025,837,3231,4309,0.194244604316547,0.749825945695057,2394,-0.55558134137851,29025,4171,1313,2724,25,29,0.314792615679693,0.653080795972189,1411,-0.338288180292496
MO,Callaway County,29027,4988,13052,19127,0.260783186072045,0.682386155696136,8064,-0.421602969624092,29027,18228,6070,11742,27,29,0.333004169409699,0.644173798551679,5672,-0.311169629141979
MO,Camden County,29029,4706,16721,22182,0.212153998737715,0.753809395004959,12015,-0.541655396267244,29029,21942,6458,15089,29,29,0.294321392762738,0.687676601950597,8631,-0.393355209187859
MO,Cape Girardeau County,29031,8468,26939,36875,0.229640677966102,0.730549152542373,18471,-0.500908474576271,29031,35672,9713,25343,31,29,0.272286387082305,0.71044516707782,15630,-0.438158779995515
MO,Carroll County,29033,745,3480,4361,0.170832377894978,0.797982114193992,2735,-0.627149736299014,29033,4304,1154,3072,33,29,0.268122676579926,0.713754646840149,1918,-0.445631970260223
MO,Carter County,29035,436,2323,2842,0.153413089373681,0.817382125263899,1887,-0.663969035890218,29035,2799,754,1978,35,29,0.269381922115041,0.706680957484816,1224,-0.437299035369775
MO,Cass County,29037,14816,33006,50715,0.292142364192054,0.650813368825791,18190,-0.358671004633738,29037,48913,17044,30912,37,29,0.348455420849263,0.631979228425981,13868,-0.283523807576718
MO,Cedar County,29039,1010,5019,6278,0.160879260911118,0.799458426250398,4009,-0.63857916533928,29039,6043,1536,4375,39,29,0.254178388217773,0.723978156544762,2839,-0.46979976832699
MO,Chariton County,29041,888,2948,3962,0.224129227662796,0.744068652195861,2060,-0.519939424533064,29041,3821,1339,2402,41,29,0.350431824129809,0.628631248364303,1063,-0.278199424234494
MO,Christian County,29043,8505,30941,41394,0.205464560081171,0.747475479538097,22436,-0.542010919456926,29043,37952,9809,27465,43,29,0.25845805227656,0.723677276559865,17656,-0.465219224283305
MO,Clark County,29045,724,2458,3316,0.218335343787696,0.741254523522316,1734,-0.52291917973462,29045,3225,1398,1730,45,29,0.433488372093023,0.536434108527132,332,-0.102945736434109
MO,Clay County,29047,45182,57328,109237,0.413614434669572,0.524803866821681,12146,-0.11118943215211,29047,105465,47250,56131,47,29,0.44801592945527,0.532223960555635,8881,-0.084208031100365
MO,Clinton County,29049,2572,7058,10197,0.252231048347553,0.692164362067275,4486,-0.439933313719722,29049,9830,3685,5904,49,29,0.374872838250254,0.600610376398779,2219,-0.225737538148525
MO,Cole County,29051,10907,24610,37261,0.292718928638523,0.660476101017149,13703,-0.367757172378626,29051,37058,12003,24488,51,29,0.323897673916563,0.660801986075881,12485,-0.336904312159318
MO,Cooper County,29053,1932,5623,7976,0.24222668004012,0.704989969909729,3691,-0.462763289869609,29053,7511,2474,4887,53,29,0.329383570762881,0.650645719611237,2413,-0.321262148848356
MO,Crawford County,29055,1824,7724,9920,0.183870967741935,0.778629032258065,5900,-0.594758064516129,29055,9579,2951,6434,55,29,0.308069735880572,0.6716776281449,3483,-0.363607892264328
MO,Dade County,29057,637,3184,3951,0.161225006327512,0.805871931156669,2547,-0.644646924829157,29057,3896,939,2895,57,29,0.241016427104723,0.743069815195072,1956,-0.502053388090349
MO,Dallas County,29059,1271,5895,7440,0.170833333333333,0.792338709677419,4624,-0.621505376344086,29059,7279,2122,4992,59,29,0.291523560928699,0.685808490177222,2870,-0.394284929248523
MO,Daviess County,29061,730,2763,3689,0.197885605855245,0.748983464353483,2033,-0.551097858498238,29061,3512,1124,2282,61,29,0.32004555808656,0.649772209567198,1158,-0.329726651480638
MO,DeKalb County,29063,824,3540,4590,0.179520697167756,0.77124183006536,2716,-0.591721132897604,29063,4350,1194,3056,63,29,0.27448275862069,0.702528735632184,1862,-0.428045977011494
MO,Dent County,29065,978,5599,6778,0.144290351136028,0.826054883446444,4621,-0.681764532310416,29065,6643,1585,4883,65,29,0.238597019418937,0.735059461086858,3298,-0.496462441667921
MO,Douglas County,29067,984,5486,6664,0.14765906362545,0.823229291716687,4502,-0.675570228091237,29067,6556,1709,4649,67,29,0.260677242220866,0.709121415497254,2940,-0.448444173276388
MO,Dunklin County,29069,2360,8026,10574,0.223188954038207,0.759031586911292,5666,-0.535842632873085,29069,10649,3635,6849,69,29,0.341346605315053,0.643158982064044,3214,-0.30181237674899
MO,Franklin County,29071,12339,35420,50045,0.246558097712059,0.707763013288041,23081,-0.461204915575982,29071,46573,16294,29271,71,29,0.349859360573723,0.628497197947308,12977,-0.278637837373586
MO,Gasconade County,29073,1519,5670,7444,0.204056958624395,0.761687264911338,4151,-0.557630306286942,29073,7134,2099,4895,73,29,0.294224838800112,0.686150827025512,2796,-0.391925988225399
MO,Gentry County,29075,605,2304,3033,0.199472469502143,0.759643916913947,1699,-0.560171447411804,29075,2997,937,1986,75,29,0.312645979312646,0.662662662662663,1049,-0.350016683350017
MO,Greene County,29077,42400,77387,127609,0.33226496563722,0.606438417353008,34987,-0.274173451715788,29077,125639,46130,76786,77,29,0.367163062424884,0.611163731007092,30656,-0.244000668582208
MO,Grundy County,29079,780,3462,4413,0.17675050985724,0.784500339904827,2682,-0.607749830047587,29079,4374,1212,3030,79,29,0.277091906721536,0.692729766803841,1818,-0.415637860082305
MO,Harrison County,29081,574,2965,3682,0.155893536121673,0.805268875611081,2391,-0.649375339489408,29081,3695,984,2624,81,29,0.266305818673884,0.710148849797023,1640,-0.443843031123139
MO,Henry County,29083,2356,7072,9855,0.239066463723998,0.717605276509386,4716,-0.478538812785388,29083,10121,3604,6229,83,29,0.356091295326549,0.615453018476435,2625,-0.259361723149886
MO,Hickory County,29085,1016,3539,4717,0.215391138435446,0.750264998940004,2523,-0.534873860504558,29085,4680,1733,2835,85,29,0.370299145299145,0.605769230769231,1102,-0.235470085470085
MO,Holt County,29087,346,1926,2348,0.147359454855196,0.820272572402044,1580,-0.672913117546848,29087,2310,551,1725,87,29,0.238528138528138,0.746753246753247,1174,-0.508225108225108
MO,Howard County,29089,1279,3277,4851,0.263656977942692,0.675530818387961,1998,-0.411873840445269,29089,4861,1722,3012,89,29,0.354248097099362,0.61962559144209,1290,-0.265377494342728
MO,Howell County,29091,2880,13888,17415,0.165374677002584,0.797473442434683,11008,-0.632098765432099,29091,16341,4393,11541,91,29,0.268832996756624,0.706260326785386,7148,-0.437427330028762
MO,Iron County,29093,933,3173,4260,0.219014084507042,0.744835680751174,2240,-0.525821596244131,29093,4031,1669,2252,93,29,0.414041180848425,0.558670305135202,583,-0.144629124286777
MO,Jackson County,29095,163723,114777,294063,0.556761646313885,0.39031432040073,48946,0.166447325913155,29095,306854,180100,121891,95,29,0.58692407464136,0.397227997679678,58209,0.189696076961682
MO,Jasper County,29097,10565,35058,48179,0.21928641109197,0.727661429253409,24493,-0.50837501816144,29097,45213,12808,31345,97,29,0.283281357131798,0.693274058346051,18537,-0.409992701214253
MO,Jefferson County,29099,31546,68973,105969,0.297690834111863,0.65087903065991,37427,-0.353188196548047,29099,97613,41570,53973,99,29,0.425865407271573,0.552928400930204,12403,-0.127062993658632
MO,Johnson County,29101,5924,13702,21087,0.280931379522929,0.649784227249016,7778,-0.368852847726087,29101,21001,7661,12750,101,29,0.364792152754631,0.607113946954907,5089,-0.242321794200276
MO,Knox County,29103,379,1413,1867,0.20299946438136,0.75682913765399,1034,-0.55382967327263,29103,1957,698,1205,103,29,0.356668369954011,0.615738375063873,507,-0.259070005109862
MO,Laclede County,29105,2543,12834,15959,0.159345823673162,0.804185725922677,10291,-0.644839902249514,29105,15361,4093,10934,105,29,0.266454006900592,0.711802617017121,6841,-0.445348610116529
MO,Lafayette County,29107,4047,10977,15815,0.255896300980082,0.694087891242491,6930,-0.438191590262409,29107,15786,5650,9800,107,29,0.357912073989611,0.62080324338021,4150,-0.262891169390599
MO,Lawrence County,29109,2898,13084,16674,0.173803526448363,0.7846947343169,10186,-0.610891207868538,29109,15748,4014,11417,109,29,0.25488950977902,0.7249809499619,7403,-0.47009144018288
MO,Lewis County,29111,933,3343,4452,0.209568733153639,0.750898472596586,2410,-0.541329739442947,29111,4278,1507,2677,111,29,0.352267414679757,0.625759700794764,1170,-0.273492286115007
MO,Lincoln County,29113,5561,18111,24857,0.223719676549865,0.728607635676067,12550,-0.504887959126202,29113,22649,7733,14330,113,29,0.341427877610491,0.632699015409069,6597,-0.291271137798578
MO,Linn County,29115,1239,4084,5572,0.222361809045226,0.732950466618808,2845,-0.510588657573582,29115,5527,2031,3331,115,29,0.367468789578433,0.602677763705446,1300,-0.235208974127013
MO,Livingston County,29117,1265,4879,6408,0.197409488139825,0.761392009987516,3614,-0.56398252184769,29117,6054,1906,4006,117,29,0.314833168153287,0.661711265279154,2100,-0.346878097125867
MO,McDonald County,29119,1329,6599,8233,0.161423539414551,0.80153042633305,5270,-0.640106886918499,29119,7817,1920,5694,119,29,0.245618523730331,0.728412434437764,3774,-0.482793910707432
MO,Macon County,29121,1518,5794,7579,0.200290275761974,0.764480802216651,4276,-0.564190526454677,29121,7159,2309,4700,121,29,0.322531079759743,0.656516273222517,2391,-0.333985193462774
MO,Madison County,29123,1005,4102,5318,0.188980819857089,0.771342610003761,3097,-0.582361790146672,29123,4930,1588,3227,123,29,0.32210953346856,0.654563894523327,1639,-0.332454361054767
MO,Maries County,29125,794,3559,4498,0.176522899066252,0.791240551356158,2765,-0.614717652289907,29125,4538,1299,3165,125,29,0.286249449096518,0.697443807844866,1866,-0.411194358748347
MO,Marion County,29127,2993,9418,12902,0.231979538056115,0.729964346612928,6425,-0.497984808556813,29127,12164,4034,7926,127,29,0.331634330812233,0.651594870108517,3892,-0.319960539296284
MO,Mercer County,29129,216,1486,1739,0.124209315698677,0.854514088556642,1270,-0.730304772857964,29129,1655,353,1255,129,29,0.213293051359517,0.758308157099698,902,-0.545015105740181
MO,Miller County,29131,1750,9285,11414,0.153320483616611,0.813474680217277,7535,-0.660154196600666,29131,11019,2651,8099,131,29,0.24058444504946,0.735003176331791,5448,-0.494418731282331
MO,Mississippi County,29133,1458,3600,5165,0.282284607938045,0.696999031945789,2142,-0.414714424007744,29133,4918,1857,2996,133,29,0.377592517283449,0.609190727938186,1139,-0.231598210654738
MO,Moniteau County,29135,1237,5344,6808,0.181698002350176,0.784958871915394,4107,-0.603260869565217,29135,6442,1608,4703,135,29,0.249611921763427,0.730052778640174,3095,-0.480440856876746
MO,Monroe County,29137,853,3159,4147,0.205690860863275,0.761755485893417,2306,-0.556064625030142,29137,4057,1398,2564,137,29,0.34458959822529,0.631994084298743,1166,-0.287404486073453
MO,Montgomery County,29139,1118,4124,5424,0.206120943952802,0.760324483775811,3006,-0.554203539823009,29139,5317,1734,3486,139,29,0.326123753996615,0.655632875681775,1752,-0.329509121685161
MO,Morgan County,29141,1768,6757,8815,0.200567214974475,0.766534316505956,4989,-0.56596710153148,29141,8688,2773,5733,141,29,0.319175874769797,0.659875690607735,2960,-0.340699815837937
MO,New Madrid County,29143,1933,5270,7352,0.262921653971708,0.716811751904244,3337,-0.453890097932535,29143,7250,2814,4284,143,29,0.388137931034483,0.590896551724138,1470,-0.202758620689655
MO,Newton County,29145,4988,20546,26506,0.188183807439825,0.775145250132046,15558,-0.586961442692221,29145,25080,6425,18179,145,29,0.256180223285486,0.724840510366826,11754,-0.46866028708134
MO,Nodaway County,29147,2529,6379,9439,0.267930924886111,0.675813115796165,3850,-0.407882190910054,29147,8976,3172,5593,147,29,0.353386809269162,0.623106060606061,2421,-0.269719251336898
MO,Oregon County,29149,865,3668,4664,0.185463121783877,0.786449399656947,2803,-0.60098627787307,29149,4421,1419,2886,149,29,0.320968106763176,0.652793485636734,1467,-0.331825378873558
MO,Osage County,29151,998,5845,7078,0.141000282565697,0.825798248092681,4847,-0.684797965526985,29151,6918,1472,5330,151,29,0.212778259612605,0.770453888407054,3858,-0.557675628794449
MO,Ozark County,29153,724,3639,4501,0.160853143745834,0.808487002888247,2915,-0.647633859142413,29153,4453,1261,3080,153,29,0.283179878733438,0.691668538064226,1819,-0.408488659330788
MO,Pemiscot County,29155,1946,3964,6025,0.32298755186722,0.65792531120332,2018,-0.3349377593361,29155,6333,2671,3596,155,29,0.421759039949471,0.567819358913627,925,-0.146060318964156
MO,Perry County,29157,1520,6907,8732,0.174072377462208,0.790998625744389,5387,-0.616926248282181,29157,7987,2184,5669,157,29,0.273444347063979,0.709778389883561,3485,-0.436334042819582
MO,Pettis County,29159,4322,12792,18045,0.239512330285398,0.708894430590191,8470,-0.469382100304794,29159,17171,5902,10840,159,29,0.34371906120785,0.631296954166909,4938,-0.287577892959059
MO,Phelps County,29161,4761,12699,18499,0.257365262987188,0.686469538893994,7938,-0.429104275906806,29161,18188,5798,11893,161,29,0.318781614251155,0.653892676489993,6095,-0.335111062238839
MO,Pike County,29163,1806,5274,7375,0.244881355932203,0.715118644067797,3468,-0.470237288135593,29163,7319,2581,4576,163,29,0.352643803798333,0.625222024866785,1995,-0.272578221068452
MO,Platte County,29165,18915,24975,46641,0.405544478034347,0.535473081623464,6060,-0.129928603589117,29165,45547,19171,25617,165,29,0.420905877445276,0.562430017344721,6446,-0.141524139899445
MO,Polk County,29167,2630,10435,13709,0.191844773506456,0.761178787657743,7805,-0.569334014151287,29167,13119,3580,9252,167,29,0.272886652946109,0.705236679624971,5672,-0.432350026678863
MO,Pulaski County,29169,2918,9870,13443,0.217064643308785,0.734211113590716,6952,-0.517146470281931,29169,13571,4199,9092,169,29,0.309409770834868,0.669957998673642,4893,-0.360548227838774
MO,Putnam County,29171,352,1936,2342,0.150298889837745,0.8266438941076,1584,-0.676345004269855,29171,2309,587,1673,171,29,0.254222607189259,0.724556084885232,1086,-0.470333477695972
MO,Ralls County,29173,1138,3969,5266,0.216103304215724,0.753703000379795,2831,-0.537599696164071,29173,5036,1736,3231,173,29,0.344718030182685,0.641580619539317,1495,-0.296862589356632
MO,Randolph County,29175,2283,7529,10309,0.221456979338442,0.730332718983413,5246,-0.50887573964497,29175,9944,3031,6667,175,29,0.304806918744972,0.670454545454545,3636,-0.365647626709574
MO,Ray County,29177,3088,7103,10835,0.285002307337333,0.65556068297185,4015,-0.370558375634518,29177,10346,4264,5805,177,29,0.412139957471487,0.561086410206843,1541,-0.148946452735357
MO,Reynolds County,29179,540,2402,3032,0.178100263852243,0.79221635883905,1862,-0.614116094986807,29179,3196,1155,1927,179,29,0.361389236545682,0.602941176470588,772,-0.241551939924906
MO,Ripley County,29181,830,4520,5518,0.150416817687568,0.819137368611816,3690,-0.668720550924248,29181,5263,1396,3743,181,29,0.265247957438723,0.711191335740072,2347,-0.445943378301349
MO,St. Charles County,29183,68225,120899,199513,0.341957666918948,0.605970538260665,52674,-0.264012871341717,29183,185597,71798,110732,183,29,0.386848925359785,0.596626023049941,38934,-0.209777097690157
MO,St. Clair County,29185,936,3501,4630,0.202159827213823,0.756155507559395,2565,-0.553995680345572,29185,4626,1460,3019,185,29,0.315607436230004,0.652615650670125,1559,-0.337008214440121
MO,Ste. Genevieve County,29186,2540,5495,8459,0.300271899751744,0.649603972100721,2955,-0.349332072348977,29186,8070,3813,4055,186,29,0.472490706319703,0.502478314745973,242,-0.02998760842627
MO,St. Francois County,29187,6250,17467,24714,0.252893097030023,0.706765396131747,11217,-0.453872299101724,29187,22590,8837,13248,187,29,0.391190792386011,0.586454183266932,4411,-0.195263390880921
MO,St. Louis County,29189,280866,199081,503493,0.557834964934964,0.395399737434284,81785,0.16243522750068,29189,524628,294735,223102,189,29,0.561798074063908,0.425257515801673,71633,0.136540558262235
MO,Saline County,29195,2787,5977,9245,0.301460248783126,0.646511627906977,3190,-0.345051379123851,29195,9095,3785,5096,195,29,0.416162726772952,0.560307861462342,1311,-0.14414513468939
MO,Schuyler County,29197,354,1505,1933,0.183135023279876,0.778582514226591,1151,-0.595447490946715,29197,1939,697,1174,197,29,0.359463641052089,0.605466735430634,477,-0.246003094378546
MO,Scotland County,29199,365,1525,1968,0.185467479674797,0.77489837398374,1160,-0.589430894308943,29199,1936,643,1246,199,29,0.332128099173554,0.643595041322314,603,-0.31146694214876
MO,Scott County,29201,3574,13168,17244,0.207260496404546,0.76362792855486,9594,-0.556367432150313,29201,16999,5122,11623,201,29,0.301311841873051,0.683746102711924,6501,-0.382434260838873
MO,Shannon County,29203,776,2966,3904,0.198770491803279,0.759733606557377,2190,-0.560963114754098,29203,3688,1300,2260,203,29,0.352494577006508,0.612798264642082,960,-0.260303687635575
MO,Shelby County,29205,606,2524,3252,0.186346863468635,0.776137761377614,1918,-0.589790897908979,29205,3232,966,2188,205,29,0.298886138613861,0.676980198019802,1222,-0.378094059405941
MO,Stoddard County,29207,1873,11077,13278,0.14106040066275,0.834237083898177,9204,-0.693176683235427,29207,12866,3153,9496,207,29,0.245064511114565,0.738069330017099,6343,-0.493004818902534
MO,Stone County,29209,2886,13149,16538,0.174507195549643,0.795078002176805,10263,-0.620570806627162,29209,15974,3920,11780,209,29,0.245398773006135,0.737448353574559,7860,-0.492049580568424
MO,Sullivan County,29211,526,1884,2484,0.211755233494364,0.758454106280193,1358,-0.546698872785829,29211,2595,908,1610,211,29,0.34990366088632,0.620423892100193,702,-0.270520231213873
MO,Taney County,29213,4367,18240,23399,0.186631907346468,0.779520492328732,13873,-0.592888584982264,29213,21608,5462,15713,213,29,0.252776749352092,0.727184376156979,10251,-0.474407626804887
MO,Texas County,29215,1728,8875,10935,0.158024691358025,0.811614083219022,7147,-0.653589391860997,29215,10764,2871,7618,215,29,0.266722408026756,0.707729468599034,4747,-0.441007060572278
MO,Vernon County,29217,1706,6526,8576,0.19892723880597,0.760960820895522,4820,-0.562033582089552,29217,8519,2580,5756,217,29,0.30285244747036,0.675666157999765,3176,-0.372813710529405
MO,Warren County,29219,3915,11109,15766,0.248319167829507,0.704617531396676,7194,-0.45629836356717,29219,14676,5219,9150,219,29,0.355614608885255,0.62346688470973,3931,-0.267852275824475
MO,Washington County,29221,1926,7047,9279,0.207565470417071,0.759456838021338,5121,-0.551891367604268,29221,8616,3402,5008,221,29,0.394846796657382,0.581244196843083,1606,-0.186397400185701
MO,Wayne County,29223,946,4640,5738,0.164865806901359,0.808644126873475,3694,-0.643778319972116,29223,5718,1811,3790,223,29,0.316719132563833,0.662819167541098,1979,-0.346100034977265
MO,Webster County,29225,3173,12829,16690,0.190113840623128,0.768663870581186,9656,-0.578550029958059,29225,15421,4407,10702,225,29,0.285779132351988,0.69398871668504,6295,-0.408209584333052
MO,Worth County,29227,195,808,1046,0.186424474187381,0.772466539196941,613,-0.58604206500956,29227,1048,341,664,227,29,0.325381679389313,0.633587786259542,323,-0.308206106870229
MO,Wright County,29229,1166,6703,8086,0.14419985159535,0.828963640860747,5537,-0.684763789265397,29229,7956,1953,5831,229,29,0.245475113122172,0.732905982905983,3878,-0.487430869783811
MO,St. Louis city,29510,101487,20281,127403,0.796582498057346,0.159187774228236,81206,0.637394723829109,29510,141135,116654,22617,510,29,0.826541963368406,0.160250823679456,94037,0.66629113968895
MT,Beaverhead County,30001,1115,3243,4676,0.238451668092387,0.693541488451668,2128,-0.455089820359281,30001,4749,1347,3251,1,30,0.283638660770689,0.684565171615077,1904,-0.400926510844388
MT,Big Horn County,30003,2061,1833,4148,0.496865959498553,0.441899710703954,228,0.0549662487946,30003,4561,2830,1655,3,30,0.620477965358474,0.362859022144267,1175,0.257618943214207
MT,Blaine County,30005,1187,1259,2621,0.452880579931324,0.480351011064479,72,-0.027470431133155,30005,2832,1598,1169,5,30,0.564265536723164,0.412782485875706,429,0.151483050847458
MT,Broadwater County,30007,566,2329,3097,0.182757507265095,0.752018082014853,1763,-0.569260574749758,30007,3005,761,2150,7,30,0.25324459234609,0.715474209650582,1389,-0.462229617304492
MT,Carbon County,30009,1824,3729,5923,0.307952051325342,0.629579604929934,1905,-0.321627553604592,30009,5806,2126,3513,9,30,0.366172924560799,0.605063727178781,1387,-0.238890802617981
MT,Carter County,30011,70,677,777,0.09009009009009,0.871299871299871,607,-0.781209781209781,30011,794,96,678,11,30,0.120906801007557,0.853904282115869,582,-0.732997481108312
MT,Cascade County,30013,12053,19343,33791,0.356692610458406,0.57243052883904,7290,-0.215737918380634,30013,33952,14949,18039,13,30,0.440298067860509,0.5313089066918,3090,-0.091010838831291
MT,Chouteau County,30015,729,1676,2571,0.283547257876313,0.651886425515364,947,-0.368339167639051,30015,2804,969,1751,15,30,0.345577746077033,0.624465049928673,782,-0.278887303851641
MT,Custer County,30017,1172,3638,5145,0.22779397473275,0.70709426627794,2466,-0.479300291545189,30017,5336,1824,3353,17,30,0.341829085457271,0.628373313343328,1529,-0.286544227886057
MT,Daniels County,30019,167,729,952,0.175420168067227,0.765756302521008,562,-0.590336134453782,30019,1001,236,735,19,30,0.235764235764236,0.734265734265734,499,-0.498501498501499
MT,Dawson County,30021,786,3298,4297,0.182918315103561,0.76751221782639,2512,-0.58459390272283,30021,4417,1219,3024,21,30,0.275979171383292,0.684627575277337,1805,-0.408648403894046
MT,Deer Lodge County,30023,2018,1736,4099,0.492315198828983,0.423517931202732,282,0.06879726762625,30023,4408,2829,1431,23,30,0.641787658802178,0.324637023593466,1398,0.317150635208711
MT,Fallon County,30025,154,1276,1474,0.104477611940299,0.865671641791045,1122,-0.761194029850746,30025,1399,236,1123,25,30,0.168691922802001,0.802716225875625,887,-0.634024303073624
MT,Fergus County,30027,1196,4235,5782,0.206848841231408,0.732445520581114,3039,-0.525596679349706,30027,6044,1628,4243,27,30,0.269358041032429,0.702018530774322,2615,-0.432660489741893
MT,Flathead County,30029,13233,30079,46144,0.286776178918169,0.65185072815534,16846,-0.365074549237171,30029,42465,13534,27694,29,30,0.318709525491581,0.652160602849405,14160,-0.333451077357824
MT,Gallatin County,30031,23879,23360,52169,0.457723935670609,0.447775498859476,519,0.009948436811133,30031,47113,21534,24051,31,30,0.457071296669709,0.510496041432301,2517,-0.053424744762592
MT,Garfield County,30033,34,653,715,0.047552447552448,0.913286713286713,619,-0.865734265734266,30033,700,66,622,33,30,0.094285714285714,0.888571428571428,556,-0.794285714285714
MT,Glacier County,30035,3076,1598,4969,0.619038035822097,0.321593882068827,1478,0.29744415375327,30035,4287,2784,1391,35,30,0.649405178446466,0.324469325868906,1393,0.32493585257756
MT,Golden Valley County,30037,71,365,468,0.151709401709402,0.77991452991453,294,-0.628205128205128,30037,479,110,351,37,30,0.22964509394572,0.732776617954071,241,-0.503131524008351
MT,Granite County,30039,469,1185,1762,0.266174801362088,0.672531214528944,716,-0.406356413166856,30039,1705,533,1107,39,30,0.312609970674487,0.649266862170088,574,-0.336656891495601
MT,Hill County,30041,2350,3446,6347,0.370253663147944,0.542933669450134,1096,-0.17268000630219,30041,6757,3372,3133,41,30,0.499038034630753,0.463667307976913,239,0.035370726653841
MT,Jefferson County,30043,1975,4099,6535,0.302218821729151,0.627237949502678,2124,-0.325019127773527,30043,6490,2256,4042,43,30,0.347611710323575,0.622804314329738,1786,-0.275192604006163
MT,Judith Basin County,30045,232,867,1189,0.195121951219512,0.729184188393608,635,-0.534062237174096,30045,1212,336,852,45,30,0.277227722772277,0.702970297029703,516,-0.425742574257426
MT,Lake County,30047,4703,7453,12898,0.364630175220964,0.577841525817956,2750,-0.213211350596992,30047,13156,5715,7084,47,30,0.434402553967771,0.538461538461538,1369,-0.104058984493767
MT,Lewis and Clark County,30049,14331,16665,33697,0.425290085170787,0.494554411371932,2334,-0.069264326201146,30049,33032,15479,16673,49,30,0.468606200048438,0.504752966820053,1194,-0.036146766771616
MT,Liberty County,30051,205,695,949,0.216016859852476,0.732349841938883,490,-0.516332982086407,30051,983,257,698,51,30,0.261444557477111,0.710071210579858,441,-0.448626653102747
MT,Lincoln County,30053,2040,6720,9250,0.22054054054054,0.726486486486486,4680,-0.505945945945946,30053,8869,2544,6045,53,30,0.286841808546623,0.681587552147931,3501,-0.394745743601308
MT,McCone County,30055,154,858,1056,0.145833333333333,0.8125,704,-0.666666666666667,30055,988,221,742,55,30,0.223684210526316,0.751012145748988,521,-0.527327935222672
MT,Madison County,30057,1175,3280,4708,0.249575191163976,0.696686491079015,2105,-0.447111299915038,30057,4511,1285,3115,57,30,0.284859232986034,0.690534249612059,1830,-0.405675016626025
MT,Meagher County,30059,191,728,970,0.196907216494845,0.750515463917526,537,-0.55360824742268,30059,972,269,670,59,30,0.276748971193416,0.689300411522634,401,-0.412551440329218
MT,Mineral County,30061,515,1322,1974,0.260891590678825,0.669706180344478,807,-0.408814589665654,30061,2009,698,1212,61,30,0.347436535589846,0.603285216525635,514,-0.255848680935789
MT,Missoula County,30063,30740,21699,57271,0.536746346318381,0.37888285519722,9041,0.157863491121161,30063,59374,34380,23285,63,30,0.579041331222421,0.392175026105703,11095,0.186866305116718
MT,Musselshell County,30065,331,1961,2404,0.137687188019967,0.815723793677205,1630,-0.678036605657238,30065,2353,482,1792,65,30,0.204844878878028,0.761580960475988,1310,-0.55673608159796
MT,Park County,30067,3521,4872,9056,0.388803003533569,0.537985865724382,1351,-0.149182862190813,30067,8634,3728,4637,67,30,0.431781329627056,0.537062775075284,909,-0.105281445448228
MT,Petroleum County,30069,30,276,319,0.094043887147336,0.865203761755486,246,-0.77115987460815,30069,298,49,240,69,30,0.164429530201342,0.805369127516778,191,-0.640939597315436
MT,Phillips County,30071,315,1715,2147,0.146716348393107,0.798789007918025,1400,-0.652072659524919,30071,2228,471,1688,71,30,0.211400359066427,0.757630161579892,1217,-0.546229802513465
MT,Pondera County,30073,737,1786,2692,0.273774145616642,0.663447251114413,1049,-0.389673105497771,30073,2704,969,1666,73,30,0.35835798816568,0.61612426035503,697,-0.257766272189349
MT,Powder River County,30075,127,880,1047,0.121298949379179,0.840496657115568,753,-0.71919770773639,30075,1019,170,833,75,30,0.166830225711482,0.817468105986261,663,-0.650637880274779
MT,Powell County,30077,549,2017,2768,0.198338150289017,0.728684971098266,1468,-0.530346820809249,30077,2763,884,1798,77,30,0.319942091929063,0.650741947158885,914,-0.330799855229823
MT,Prairie County,30079,100,555,686,0.145772594752187,0.809037900874636,455,-0.663265306122449,30079,701,167,518,79,30,0.238231098430813,0.738944365192582,351,-0.500713266761769
MT,Ravalli County,30081,6166,14673,22063,0.279472419888501,0.665050083850791,8507,-0.38557766396229,30081,19797,6466,12817,81,30,0.326615143708643,0.647421326463606,6351,-0.320806182754963
MT,Richland County,30083,669,3885,4812,0.139027431421446,0.807356608478803,3216,-0.668329177057357,30083,4602,992,3479,83,30,0.215558452846588,0.755975662755324,2487,-0.540417209908735
MT,Roosevelt County,30085,1504,1722,3486,0.431440045897877,0.493975903614458,218,-0.062535857716581,30085,3618,2044,1503,85,30,0.564953012714207,0.415422885572139,541,0.149530127142067
MT,Rosebud County,30087,969,2211,3357,0.288650580875782,0.658623771224307,1242,-0.369973190348525,30087,3610,1478,2035,87,30,0.409418282548477,0.563711911357341,557,-0.154293628808864
MT,Sanders County,30089,1211,4268,5871,0.206268097428036,0.726963038664623,3057,-0.520694941236587,30089,5888,1716,3971,89,30,0.291440217391304,0.674422554347826,2255,-0.382982336956522
MT,Sheridan County,30091,476,1237,1825,0.260821917808219,0.677808219178082,761,-0.416986301369863,30091,1920,661,1203,91,30,0.344270833333333,0.6265625,542,-0.282291666666667
MT,Silver Bow County,30093,8545,6252,16122,0.530021089194889,0.387793077781913,2293,0.142228011412976,30093,16617,10782,5374,93,30,0.648853583679365,0.323403743154601,5408,0.325449840524764
MT,Stillwater County,30095,904,3630,4816,0.187707641196013,0.753737541528239,2726,-0.566029900332226,30095,4560,1209,3237,95,30,0.265131578947368,0.709868421052632,2028,-0.444736842105263
MT,Sweet Grass County,30097,398,1580,2077,0.191622532498796,0.760712566201252,1182,-0.569090033702455,30097,2105,473,1584,97,30,0.224703087885986,0.75249406175772,1111,-0.527790973871734
MT,Teton County,30099,803,2152,3143,0.255488386891505,0.684696150174992,1349,-0.429207763283487,30099,3250,1073,2091,99,30,0.330153846153846,0.643384615384615,1018,-0.313230769230769
MT,Toole County,30101,399,1495,2018,0.197720515361744,0.740832507433102,1096,-0.543111992071358,30101,2102,582,1440,101,30,0.276879162702188,0.685061845861085,858,-0.408182683158896
MT,Treasure County,30103,59,350,441,0.133786848072562,0.793650793650794,291,-0.659863945578231,30103,453,114,317,103,30,0.251655629139073,0.699779249448124,203,-0.448123620309051
MT,Valley County,30105,886,2697,3860,0.229533678756477,0.698704663212435,1811,-0.469170984455958,30105,3860,1386,2337,105,30,0.359067357512953,0.605440414507772,951,-0.246373056994819
MT,Wheatland County,30107,179,698,932,0.19206008583691,0.748927038626609,519,-0.5568669527897,30107,989,272,690,107,30,0.275025278058645,0.697674418604651,418,-0.422649140546006
MT,Wibaux County,30109,55,460,533,0.103189493433396,0.863039399624766,405,-0.75984990619137,30109,544,25,421,109,30,0.045955882352941,0.773897058823529,396,-0.727941176470588
MT,Yellowstone County,30111,21117,38675,64675,0.326509470429068,0.597989949748744,17558,-0.271480479319675,30111,68561,26275,40421,111,30,0.383235367045405,0.589562579308937,14146,-0.206327212263532
NE,Adams County,31001,3272,9205,13172,0.248405709079866,0.698830853325235,5933,-0.450425144245369,31001,12451,3991,8235,1,31,0.320536503092121,0.661392659224159,4244,-0.340856156132038
NE,Antelope County,31003,381,2717,3220,0.11832298136646,0.843788819875776,2336,-0.725465838509317,31003,3209,571,2585,3,31,0.177937052041134,0.80554689934559,2014,-0.627609847304456
NE,Arthur County,31005,16,237,263,0.060836501901141,0.901140684410646,221,-0.840304182509506,31005,261,30,227,5,31,0.114942528735632,0.869731800766284,197,-0.754789272030651
NE,Banner County,31007,18,355,390,0.046153846153846,0.91025641025641,337,-0.864102564102564,31007,402,55,339,7,31,0.13681592039801,0.843283582089552,284,-0.706467661691542
NE,Blaine County,31009,30,273,313,0.095846645367412,0.87220447284345,243,-0.776357827476038,31009,301,29,268,9,31,0.096345514950166,0.890365448504983,239,-0.794019933554817
NE,Boone County,31011,414,2299,2867,0.144401813742588,0.801883501918382,1885,-0.657481688175793,31011,2799,615,2136,11,31,0.219721329046088,0.763129689174705,1521,-0.543408360128617
NE,Box Butte County,31013,953,3550,4761,0.200168031926066,0.745641671917664,2597,-0.545473639991598,31013,4541,1634,2795,13,31,0.359832635983264,0.615503193129267,1161,-0.255670557146003
NE,Boyd County,31015,128,978,1142,0.112084063047285,0.856392294220665,850,-0.74430823117338,31015,1047,186,852,15,31,0.177650429799427,0.813753581661891,666,-0.636103151862464
NE,Brown County,31017,153,1380,1579,0.096896770107663,0.873970867637745,1227,-0.777074097530082,31017,1545,223,1298,17,31,0.144336569579288,0.840129449838188,1075,-0.6957928802589
NE,Buffalo County,31019,4690,14424,20477,0.22903745665869,0.704400058602334,9734,-0.475362601943644,31019,19057,5266,13378,19,31,0.276328908012804,0.701999265361809,8112,-0.425670357349006
NE,Burt County,31021,928,2360,3523,0.26341186488788,0.669883621913142,1432,-0.406471757025263,31021,3343,1280,2016,21,31,0.382889620101705,0.603051151660185,736,-0.22016153155848
NE,Butler County,31023,690,3068,3914,0.176290240163516,0.783852835973429,2378,-0.607562595809913,31023,3818,1028,2729,23,31,0.26925091671032,0.714772132006286,1701,-0.445521215295966
NE,Cass County,31025,3461,8388,12609,0.274486477912602,0.665239114917916,4927,-0.390752637005314,31025,11952,4298,7453,25,31,0.359605087014726,0.623577643908969,3155,-0.263972556894244
NE,Cedar County,31027,572,3533,4360,0.131192660550459,0.810321100917431,2961,-0.679128440366972,31027,4260,952,3231,27,31,0.223474178403756,0.758450704225352,2279,-0.534976525821596
NE,Chase County,31029,171,1621,1851,0.092382495948136,0.875742841707185,1450,-0.783360345759049,31029,1849,252,1573,29,31,0.136289886425095,0.850730124391563,1321,-0.714440237966468
NE,Cherry County,31031,317,2623,3082,0.102855288773524,0.851070733290071,2306,-0.748215444516548,31031,3052,436,2557,31,31,0.142857142857143,0.83781127129751,2121,-0.694954128440367
NE,Cheyenne County,31033,702,3610,4569,0.153644123440578,0.790107244473627,2908,-0.636463121033049,31033,4197,983,3134,33,31,0.234214915415773,0.746723850369311,2151,-0.512508934953538
NE,Clay County,31035,470,2373,2973,0.158089471913892,0.798183652875883,1903,-0.640094180961991,31035,2916,662,2213,35,31,0.227023319615912,0.758916323731139,1551,-0.531893004115226
NE,Colfax County,31037,857,2171,3172,0.270176544766709,0.684426229508197,1314,-0.414249684741488,31037,3047,959,2045,37,31,0.314735805710535,0.6711519527404,1086,-0.356416147029865
NE,Cuming County,31039,712,3095,3988,0.178535606820461,0.776078234704112,2383,-0.597542627883651,31039,3928,1015,2858,39,31,0.258401221995927,0.727596741344196,1843,-0.469195519348269
NE,Custer County,31041,635,4616,5489,0.115685917289124,0.840954636545819,3981,-0.725268719256695,31041,5414,1066,4251,41,31,0.196896933875139,0.785186553380126,3185,-0.588289619504987
NE,Dakota County,31043,2904,4028,7259,0.400055104008817,0.554897368783579,1124,-0.154842264774762,31043,5977,2831,3048,43,31,0.473648987786515,0.509954826836205,217,-0.036305839049691
NE,Dawes County,31045,785,2559,3578,0.21939631078815,0.715204024594746,1774,-0.495807713806596,31045,3634,1102,2435,45,31,0.303247110621904,0.670060539350578,1333,-0.366813428728674
NE,Dawson County,31047,2116,5935,8486,0.249351873674287,0.699387226019326,3819,-0.450035352345039,31047,7680,2157,5370,47,31,0.280859375,0.69921875,3213,-0.418359375
NE,Deuel County,31049,120,809,977,0.122824974411464,0.828045035823951,689,-0.705220061412487,31049,1012,215,763,49,31,0.212450592885375,0.75395256916996,548,-0.541501976284585
NE,Dixon County,31051,556,2041,2744,0.202623906705539,0.743804664723032,1485,-0.541180758017493,31051,2666,870,1745,51,31,0.326331582895724,0.654538634658665,875,-0.328207051762941
NE,Dodge County,31053,4451,9736,14959,0.297546627448359,0.65084564476235,5285,-0.353299017313992,31053,14759,5588,8937,53,31,0.37861643742801,0.605528829866522,3349,-0.226912392438512
NE,Douglas County,31055,105207,102151,219531,0.479235278844446,0.465314693596804,3056,0.013920585247642,31055,210501,99261,108319,55,31,0.471546453461029,0.51457712789963,9058,-0.043030674438601
NE,Dundy County,31057,89,823,949,0.093782929399368,0.86722866174921,734,-0.773445732349842,31057,981,176,791,57,31,0.17940876656473,0.806320081549439,615,-0.626911314984709
NE,Fillmore County,31059,610,2100,2879,0.211879124696075,0.729419937478291,1490,-0.517540812782216,31059,2815,794,1972,59,31,0.282060390763766,0.700532859680284,1178,-0.418472468916519
NE,Franklin County,31061,250,1345,1656,0.150966183574879,0.81219806763285,1095,-0.661231884057971,31061,1527,381,1110,61,31,0.24950884086444,0.726915520628684,729,-0.477406679764244
NE,Frontier County,31063,161,1106,1310,0.122900763358779,0.844274809160305,945,-0.721374045801527,31063,1422,381,1005,63,31,0.267932489451477,0.706751054852321,624,-0.438818565400844
NE,Furnas County,31065,304,1915,2315,0.131317494600432,0.827213822894168,1611,-0.695896328293737,31065,2215,422,1767,65,31,0.190519187358917,0.797742663656885,1345,-0.607223476297968
NE,Gage County,31067,2930,6333,9854,0.297341181246194,0.642683174345443,3403,-0.345341993099249,31067,9552,3870,5470,67,31,0.405150753768844,0.572654941373534,1600,-0.16750418760469
NE,Garden County,31069,153,869,1063,0.143932267168391,0.817497648165569,716,-0.673565380997178,31069,1088,242,829,69,31,0.222426470588235,0.761948529411765,587,-0.539522058823529
NE,Garfield County,31071,121,819,968,0.125,0.846074380165289,698,-0.721074380165289,31071,928,147,762,71,31,0.158405172413793,0.821120689655172,615,-0.662715517241379
NE,Gosper County,31073,165,792,1000,0.165,0.792,627,-0.627,31073,975,230,732,73,31,0.235897435897436,0.750769230769231,502,-0.514871794871795
NE,Grant County,31075,20,367,394,0.050761421319797,0.931472081218274,347,-0.880710659898477,31075,363,30,322,75,31,0.082644628099174,0.887052341597796,292,-0.804407713498622
NE,Greeley County,31077,210,911,1165,0.180257510729614,0.781974248927039,701,-0.601716738197425,31077,1181,340,820,77,31,0.287891617273497,0.69432684165961,480,-0.406435224386113
NE,Hall County,31079,6142,14139,21331,0.287937743190661,0.662838122919694,7997,-0.374900379729033,31079,19721,6971,12412,79,31,0.353481060798134,0.629379848892044,5441,-0.27589878809391
NE,Hamilton County,31081,873,3763,4902,0.178090575275398,0.767645858833129,2890,-0.589555283557732,31081,4824,1136,3582,81,31,0.235489220563847,0.742537313432836,2446,-0.507048092868988
NE,Harlan County,31083,219,1302,1582,0.138432364096081,0.823008849557522,1083,-0.684576485461441,31083,1584,311,1248,83,31,0.196338383838384,0.787878787878788,937,-0.591540404040404
NE,Hayes County,31085,30,471,510,0.058823529411765,0.923529411764706,441,-0.864705882352941,31085,535,50,473,85,31,0.093457943925234,0.88411214953271,423,-0.790654205607477
NE,Hitchcock County,31087,158,1216,1440,0.109722222222222,0.844444444444444,1058,-0.734722222222222,31087,1739,310,1386,87,31,0.178263369752732,0.79700977573318,1076,-0.618746405980448
NE,Holt County,31089,522,4275,4979,0.10484032938341,0.858606145812412,3753,-0.753765816429002,31089,4749,862,3789,89,31,0.181511897241525,0.797852179406191,2927,-0.616340282164666
NE,Hooker County,31091,40,355,414,0.096618357487923,0.857487922705314,315,-0.760869565217391,31091,394,59,330,91,31,0.149746192893401,0.83756345177665,271,-0.687817258883249
NE,Howard County,31093,544,2284,2958,0.183908045977011,0.772143340094659,1740,-0.588235294117647,31093,2856,914,1890,93,31,0.320028011204482,0.661764705882353,976,-0.341736694677871
NE,Jefferson County,31095,831,2387,3430,0.242274052478134,0.695918367346939,1556,-0.453644314868805,31095,3416,1185,2156,95,31,0.346896955503513,0.631147540983607,971,-0.284250585480094
NE,Johnson County,31097,560,1348,2051,0.273037542662116,0.657240370550951,788,-0.384202827888835,31097,2057,790,1223,97,31,0.384054448225571,0.594555177442878,433,-0.210500729217307
NE,Kearney County,31099,550,2519,3242,0.169648365206663,0.776989512646515,1969,-0.607341147439852,31099,3156,761,2341,99,31,0.241128010139417,0.741761723700887,1580,-0.50063371356147
NE,Keith County,31101,560,3203,3945,0.141951837769328,0.81191381495564,2643,-0.669961977186312,31101,4026,920,3036,101,31,0.228514654744163,0.754098360655738,2116,-0.525583705911575
NE,Keya Paha County,31103,39,458,514,0.075875486381323,0.891050583657588,419,-0.815175097276265,31103,481,80,392,103,31,0.166320166320166,0.814968814968815,312,-0.648648648648649
NE,Kimball County,31105,227,1317,1636,0.138753056234719,0.805012224938875,1090,-0.666259168704156,31105,1665,391,1222,105,31,0.234834834834835,0.733933933933934,831,-0.499099099099099
NE,Knox County,31107,715,3181,4061,0.176065008618567,0.783304604777148,2466,-0.607239596158582,31107,4015,1055,2878,107,31,0.262764632627646,0.71681195516812,1823,-0.454047322540473
NE,Lancaster County,31109,60533,60456,129803,0.466345153810004,0.465751947181498,77,0.000593206628506,31109,123206,59970,61177,109,31,0.486745775368083,0.496542376182978,1207,-0.009796600814895
NE,Lincoln County,31111,2878,11992,15674,0.183616179660584,0.765088681893582,9114,-0.581472502232997,31111,15266,4350,10545,111,31,0.28494694091445,0.690750687802961,6195,-0.40580374688851
NE,Logan County,31113,32,400,451,0.070953436807095,0.886917960088692,368,-0.815964523281597,31113,431,68,356,113,31,0.157772621809745,0.825986078886311,288,-0.668213457076566
NE,Loup County,31115,48,323,382,0.12565445026178,0.845549738219895,275,-0.719895287958115,31115,356,62,290,115,31,0.174157303370787,0.814606741573034,228,-0.640449438202247
NE,McPherson County,31117,14,257,286,0.048951048951049,0.898601398601399,243,-0.84965034965035,31117,290,41,237,117,31,0.141379310344828,0.817241379310345,196,-0.675862068965517
NE,Madison County,31119,2663,10518,13956,0.190813986815707,0.753654342218401,7855,-0.562840355402694,31119,13512,3368,9874,119,31,0.249259917110716,0.730757844878626,6506,-0.48149792776791
NE,Merrick County,31121,601,2914,3707,0.162125708119773,0.786080388454276,2313,-0.623954680334502,31121,3457,921,2477,121,31,0.266415967601967,0.716517211455019,1556,-0.450101243853052
NE,Morrill County,31123,282,1788,2166,0.130193905817175,0.825484764542936,1506,-0.695290858725762,31123,2152,450,1658,123,31,0.20910780669145,0.770446096654275,1208,-0.561338289962825
NE,Nance County,31125,280,1257,1599,0.175109443402126,0.786116322701689,977,-0.611006879299562,31125,1604,477,1098,125,31,0.297381546134663,0.684538653366584,621,-0.38715710723192
NE,Nemaha County,31127,765,2068,3035,0.252059308072488,0.681383855024712,1303,-0.429324546952224,31127,3126,1089,1979,127,31,0.348368522072937,0.633077415227127,890,-0.284708893154191
NE,Nuckolls County,31129,348,1709,2153,0.161634928007431,0.793776126335346,1361,-0.632141198327914,31129,2170,567,1563,129,31,0.261290322580645,0.720276497695853,996,-0.458986175115207
NE,Otoe County,31131,2017,4833,7279,0.277098502541558,0.663964830333837,2816,-0.386866327792279,31131,6905,2542,4226,131,31,0.368139029688631,0.612020275162925,1684,-0.243881245474294
NE,Pawnee County,31133,279,970,1314,0.212328767123288,0.73820395738204,691,-0.525875190258752,31133,1330,396,897,133,31,0.297744360902256,0.674436090225564,501,-0.376691729323308
NE,Perkins County,31135,160,1202,1418,0.112834978843441,0.847672778561354,1042,-0.734837799717913,31135,1391,237,1133,135,31,0.170381020848311,0.814521926671459,896,-0.644140905823149
NE,Phelps County,31137,571,3832,4609,0.123888045129095,0.831416793230636,3261,-0.70752874810154,31137,4336,875,3372,137,31,0.20179889298893,0.777675276752767,2497,-0.575876383763838
NE,Pierce County,31139,382,3052,3580,0.106703910614525,0.852513966480447,2670,-0.745810055865922,31139,3414,637,2707,139,31,0.186584651435267,0.792911540714704,2070,-0.606326889279438
NE,Platte County,31141,2612,10864,14047,0.185947177333238,0.773403573716808,8252,-0.58745639638357,31141,13249,3095,9963,141,31,0.233602536040456,0.751981281606159,6868,-0.518378745565703
NE,Polk County,31143,411,2019,2538,0.16193853427896,0.795508274231678,1608,-0.633569739952719,31143,2446,527,1886,143,31,0.21545380212592,0.771054783319706,1359,-0.555600981193786
NE,Red Willow County,31145,638,4212,5061,0.126062043074491,0.832246591582691,3574,-0.7061845485082,31145,4868,940,3855,145,31,0.193097781429745,0.791906327033689,2915,-0.598808545603944
NE,Richardson County,31147,798,2684,3666,0.217675941080196,0.732133115111839,1886,-0.514457174031642,31147,3680,1180,2407,147,31,0.320652173913043,0.654076086956522,1227,-0.333423913043478
NE,Rock County,31149,70,687,793,0.088272383354351,0.866330390920555,617,-0.778058007566204,31149,784,103,669,149,31,0.131377551020408,0.853316326530612,566,-0.721938775510204
NE,Saline County,31151,1630,2849,4795,0.339937434827946,0.594160583941606,1219,-0.25422314911366,31151,4832,2232,2518,151,31,0.461920529801325,0.521109271523179,286,-0.059188741721854
NE,Sarpy County,31153,27704,44649,77781,0.356179529705198,0.574034789987272,16945,-0.217855260282074,31153,66166,24709,40318,153,31,0.373439530876885,0.609346189886044,15609,-0.235906659009159
NE,Saunders County,31155,2509,7486,10598,0.236742781656916,0.706359690507643,4977,-0.469616908850727,31155,10203,3279,6725,155,31,0.321376065862981,0.659119866705871,3446,-0.337743800842889
NE,Scotts Bluff County,31157,3151,9952,13895,0.226772220223102,0.716228859301907,6801,-0.489456639078805,31157,13867,4193,9427,157,31,0.302372539121656,0.679815389053148,5234,-0.377442849931492
NE,Seward County,31159,1881,5451,7754,0.242584472530307,0.702992004126902,3570,-0.460407531596595,31159,7445,2362,4947,159,31,0.317259905977166,0.664472800537273,2585,-0.347212894560107
NE,Sheridan County,31161,286,2192,2565,0.111500974658869,0.85458089668616,1906,-0.74307992202729,31161,2450,389,2010,161,31,0.158775510204082,0.820408163265306,1621,-0.661632653061224
NE,Sherman County,31163,338,1143,1553,0.217643271088216,0.735994848679974,805,-0.518351577591758,31163,1508,549,919,163,31,0.364058355437666,0.609416445623342,370,-0.245358090185676
NE,Sioux County,31165,77,602,709,0.108603667136812,0.849083215796897,525,-0.740479548660085,31165,735,101,623,165,31,0.137414965986395,0.847619047619048,522,-0.710204081632653
NE,Stanton County,31167,417,2173,2748,0.15174672489083,0.79075691411936,1756,-0.63901018922853,31167,2623,607,1945,167,31,0.231414410979794,0.741517346549752,1338,-0.510102935569958
NE,Thayer County,31169,490,1993,2613,0.187523918867202,0.762724837351703,1503,-0.575200918484501,31169,2627,724,1853,169,31,0.275599543205177,0.705367339170156,1129,-0.429767795964979
NE,Thomas County,31171,30,344,387,0.077519379844961,0.888888888888889,314,-0.811369509043928,31171,408,42,360,171,31,0.102941176470588,0.882352941176471,318,-0.779411764705882
NE,Thurston County,31173,911,1013,2029,0.448989650073928,0.499260719566289,102,-0.050271069492361,31173,1993,1153,823,173,31,0.578524836929252,0.41294530858003,330,0.165579528349222
NE,Valley County,31175,337,1770,2172,0.155156537753223,0.814917127071823,1433,-0.6597605893186,31175,2168,494,1643,175,31,0.227859778597786,0.757841328413284,1149,-0.529981549815498
NE,Washington County,31177,2606,7374,10584,0.246220710506425,0.69671201814059,4768,-0.450491307634165,31177,10121,3103,6857,177,31,0.306590257879656,0.677502223100484,3754,-0.370911965220828
NE,Wayne County,31179,828,2675,3740,0.221390374331551,0.71524064171123,1847,-0.493850267379679,31179,3659,1074,2493,179,31,0.293522820442744,0.681333697731621,1419,-0.387810877288877
NE,Webster County,31181,306,1320,1687,0.181387077652638,0.782454060462359,1014,-0.601066982809721,31181,1730,440,1255,181,31,0.254335260115607,0.725433526011561,815,-0.471098265895954
NE,Wheeler County,31183,62,377,459,0.135076252723312,0.821350762527233,315,-0.686274509803922,31183,446,93,345,183,31,0.208520179372197,0.773542600896861,252,-0.565022421524664
NE,York County,31185,1181,4686,6256,0.188778772378517,0.749040920716112,3505,-0.560262148337596,31185,6246,1352,4814,185,31,0.216458533461415,0.770733269292347,3462,-0.554274735830932
NV,Churchill County,32001,2210,7828,10936,0.202084857351865,0.715801024140453,5618,-0.513716166788588,32001,10265,2961,7061,1,32,0.288455918168534,0.687871407696055,4100,-0.399415489527521
NV,Clark County,32003,401068,319571,765421,0.523983533245103,0.41751010228358,81497,0.106473430961523,32003,688339,387978,288223,3,32,0.56364378598336,0.418722460880467,99755,0.144921325102893
NV,Douglas County,32005,8453,17406,27871,0.303290158228984,0.624520110509131,8953,-0.321229952280148,32005,26054,9288,16264,5,32,0.356490366162585,0.624241959008214,6976,-0.267751592845628
NV,Elko County,32007,3400,13542,18545,0.183337826907522,0.730223779994608,10142,-0.546885953087086,32007,15984,3510,12013,7,32,0.219594594594595,0.751564064064064,8503,-0.531969469469469
NV,Esmeralda County,32009,65,329,423,0.153664302600473,0.777777777777778,264,-0.624113475177305,32009,435,92,317,9,32,0.211494252873563,0.728735632183908,225,-0.517241379310345
NV,Eureka County,32011,74,723,854,0.086651053864169,0.846604215456675,649,-0.759953161592506,32011,808,107,663,11,32,0.132425742574257,0.820544554455445,556,-0.688118811881188
NV,Humboldt County,32013,1386,4521,6433,0.215451577801959,0.702782527592103,3135,-0.487330949790145,32013,5744,1737,3810,13,32,0.302402506963788,0.663300835654596,2073,-0.360898328690808
NV,Lander County,32015,403,1828,2413,0.167012018234563,0.757563199336925,1425,-0.590551181102362,32015,2165,534,1580,15,32,0.246651270207852,0.729792147806005,1046,-0.483140877598153
NV,Lincoln County,32017,285,1671,2132,0.133677298311445,0.783771106941839,1386,-0.650093808630394,32017,2152,400,1691,17,32,0.185873605947955,0.785780669144981,1291,-0.599907063197026
NV,Lyon County,32019,6146,16005,23762,0.258648261930814,0.673554414611565,9859,-0.414906152680751,32019,21465,7380,13520,19,32,0.343815513626834,0.629862566969485,6140,-0.286047053342651
NV,Mineral County,32021,637,1179,1997,0.318978467701552,0.590385578367551,542,-0.271407110665999,32021,2035,863,1080,21,32,0.424078624078624,0.530712530712531,217,-0.106633906633907
NV,Nye County,32023,5095,13320,19592,0.260055124540629,0.679869334422213,8225,-0.419814209881584,32023,17522,6320,10566,23,32,0.360689419016094,0.603013354639881,4246,-0.242323935623787
NV,Pershing County,32027,430,1403,1982,0.216952573158426,0.70787083753784,973,-0.490918264379415,32027,1884,632,1167,27,32,0.335456475583864,0.619426751592357,535,-0.283970276008493
NV,Storey County,32029,752,1616,2558,0.293979671618452,0.631743549648163,864,-0.337763878029711,32029,2314,920,1321,29,32,0.397579948141746,0.570872947277442,401,-0.173292999135696
NV,Washoe County,32031,97032,94529,209282,0.463642358157892,0.451682418937128,2503,0.011959939220764,32031,186917,94806,88151,31,32,0.507209082105961,0.471605043949988,6655,0.035604038155973
NV,White Pine County,32033,707,2723,3773,0.187384044526902,0.721706864564007,2016,-0.534322820037106,32033,3704,983,2601,33,32,0.265388768898488,0.702213822894168,1618,-0.43682505399568
NV,Carson City,32510,9610,13125,25016,0.384154141349536,0.524664214902462,3515,-0.140510073552926,32510,23318,10290,12394,510,32,0.441289990565229,0.531520713611802,2104,-0.090230723046574
NH,Belknap County,33001,13517,19315,34462,0.392229121931403,0.560472404387441,5798,-0.168243282456039,33001,33771,15884,17568,1,33,0.470344378312754,0.52020964733055,1684,-0.049865269017796
NH,Carroll County,33003,12987,14635,29063,0.446856828269621,0.503561229054124,1648,-0.056704400784503,33003,28464,13977,14207,3,33,0.4910413153457,0.499121697582912,230,-0.008080382237212
NH,Cheshire County,33005,22064,16876,41080,0.537098344693281,0.41080817916261,5188,0.126290165530672,33005,41071,25329,15135,5,33,0.616712522217623,0.368508193128972,10194,0.248204329088651
NH,Coos County,33007,6558,7951,15255,0.429891838741396,0.521206161914127,1393,-0.09131432317273,33007,15614,9091,6342,7,33,0.582233892660433,0.406173946458307,2749,0.176059946202126
NH,Grafton County,33009,28510,19010,50065,0.569459702386897,0.379706381703785,9500,0.189753320683112,33009,48765,29826,18207,9,33,0.611627191633344,0.373362042448477,11619,0.238265149184866
NH,Hillsborough County,33011,99589,100013,210622,0.472832847470824,0.474845932523668,424,-0.002013085052843,33011,202765,101499,98103,11,33,0.500574556752891,0.48382610411067,3396,0.016748452642221
NH,Merrimack County,33013,40198,37674,81982,0.490327144983045,0.45953989900222,2524,0.030787245980825,33013,80054,44635,34451,13,33,0.557561146226297,0.430347015764359,10184,0.127214130461938
NH,Rockingham County,33015,79994,90447,179005,0.446881372028714,0.505276388927684,10453,-0.058395016898969,33015,169794,80096,87809,15,33,0.4717245603496,0.517150193764208,7713,-0.045425633414608
NH,Strafford County,33017,34894,29072,67918,0.513766600901087,0.428045584381165,5822,0.085721016519921,33017,63762,36026,26779,17,33,0.565007371161507,0.419983689344751,9247,0.145023681816756
NH,Sullivan County,33019,10210,10796,22101,0.461970046604226,0.488484683950952,586,-0.026514637346727,33019,21814,12166,9269,19,33,0.557715228752177,0.424910607866508,2897,0.13280462088567
NJ,Atlantic County,34001,54472,47882,105738,0.515160112731468,0.452836255650759,6590,0.062323857080709,34001,102405,59509,41918,1,34,0.581114203408037,0.409335481665934,17591,0.171778721742102
NJ,Bergen County,34003,209251,163220,383965,0.544974151289831,0.425090828591148,46031,0.119883322698683,34003,352023,193470,155267,3,34,0.549594770796226,0.441070611863429,38203,0.108524158932797
NJ,Burlington County,34005,108361,79539,194988,0.555731634767268,0.407917410302172,28822,0.147814224465095,34005,197059,115951,79110,5,34,0.588407532769374,0.401453371832801,36841,0.186954160936572
NJ,Camden County,34007,142375,71020,220437,0.645876146019044,0.322178218720088,71355,0.323697927298956,34007,203201,137795,63329,7,34,0.678121662787093,0.311656930822191,74466,0.366464731964902
NJ,Cape May County,34009,18626,28237,48375,0.385033591731266,0.583710594315246,9611,-0.198677002583979,34009,47243,21275,25488,9,34,0.450331266007663,0.539508498613551,4213,-0.089177232605889
NJ,Cumberland County,34011,27045,24213,53018,0.510109774039006,0.456693952997095,2832,0.05341582104191,34011,49472,30172,18767,11,34,0.609880336351876,0.379345892626132,11405,0.230534443725744
NJ,Essex County,34013,231031,62059,299808,0.770596515102999,0.206995810652151,168972,0.563600704450849,34013,281633,217950,61595,13,34,0.773879481452813,0.218706614636779,156355,0.555172866816034
NJ,Gloucester County,34015,66355,66949,138388,0.479485215481111,0.48377749515854,594,-0.004292279677429,34015,133568,72960,58915,15,34,0.546238620028749,0.441086188308577,14045,0.105152431720173
NJ,Hudson County,34017,149980,45615,201425,0.744594762318481,0.226461462082661,104365,0.51813330023582,34017,176104,136239,38082,17,34,0.773628083405261,0.216247217553264,98157,0.557380865851997
NJ,Hunterdon County,34019,28797,38565,70582,0.407993539429316,0.546385764075827,9768,-0.13839222464651,34019,62821,25148,36979,19,34,0.400311997580427,0.588640741153436,11831,-0.188328743573009
NJ,Mercer County,34021,93721,42604,141332,0.663126538929613,0.301446240058868,51117,0.361680298870744,34021,139064,94300,43155,21,34,0.678105045159063,0.310324742564575,51145,0.367780302594489
NJ,Middlesex County,34023,164887,108981,282668,0.583323899415569,0.385544171961453,55906,0.197779727454116,34023,285232,179515,102472,23,34,0.62936486789701,0.359258428226847,77043,0.270106439670163
NJ,Monmouth County,34025,135825,165305,311474,0.436071710640374,0.530718454830901,29480,-0.094646744190526,34025,268943,125471,140376,25,34,0.466533800842558,0.521954466188003,14905,-0.055420665345445
NJ,Morris County,34027,114437,125376,248848,0.459867067446795,0.50382562849611,10939,-0.043958561049315,34027,206580,90313,114265,27,34,0.437181721367025,0.553127117823603,23952,-0.115945396456579
NJ,Ocean County,34029,81845,170103,259592,0.315283213658356,0.655270578446177,88258,-0.339987364787821,34029,237432,96500,138594,29,34,0.406432157417703,0.583720812695846,42094,-0.177288655278143
NJ,Passaic County,34031,112608,71488,189099,0.595497596497073,0.378045362482086,41120,0.217452234014987,34031,164629,104057,59181,31,34,0.632069683956047,0.359481014888021,44876,0.272588669068026
NJ,Salem County,34033,11766,16256,29220,0.402669404517454,0.556331279945243,4490,-0.153661875427789,34033,29116,14456,14214,33,34,0.496496771534551,0.488185190273389,242,0.008311581261162
NJ,Somerset County,34035,83839,64640,154249,0.543530265998483,0.419062684361001,19199,0.124467581637482,34035,134932,70168,63159,35,34,0.520024901431832,0.468080218183974,7009,0.051944683247858
NJ,Sussex County,34037,24132,46486,73860,0.326726238830219,0.629379907933929,22354,-0.30265366910371,34037,61704,23406,37215,37,34,0.379327110073901,0.603121353558926,13809,-0.223794243485025
NJ,Union County,34039,145412,67582,219385,0.662816509788728,0.308052054607197,77830,0.35476445518153,34039,202353,134220,66457,39,34,0.66329631880921,0.328421125458975,67763,0.334875193350234
NJ,Warren County,34041,16991,29393,48442,0.350749349737831,0.60676685520829,12402,-0.25601750547046,34041,43312,17869,24695,41,34,0.412564647210935,0.570165312153676,6826,-0.157600664942741
NM,Bernalillo County,35001,141960,93874,269861,0.526048595387996,0.347860565253964,48086,0.178188030134032,35001,264942,147183,104242,1,35,0.555529134678533,0.393452151791713,42941,0.16207698288682
NM,Catron County,35003,426,1453,2024,0.210474308300395,0.717885375494071,1027,-0.507411067193676,35003,2100,557,1474,3,35,0.265238095238095,0.701904761904762,917,-0.436666666666667
NM,Chaves County,35005,5530,12869,20159,0.274319162656878,0.638374919390843,7339,-0.364055756733965,35005,20498,6621,13271,5,35,0.323007122646112,0.647429017465119,6650,-0.324421894819007
NM,Cibola County,35006,3721,3179,7975,0.466583072100314,0.398620689655172,542,0.067962382445141,35006,8154,4907,2966,6,35,0.601790532254108,0.363747853814079,1941,0.238042678440029
NM,Colfax County,35007,2118,2569,5271,0.401821286283438,0.48738379814077,451,-0.085562511857333,35007,5896,2879,2763,7,35,0.488297150610583,0.468622795115333,116,0.019674355495251
NM,Curry County,35009,2776,7560,11292,0.2458377612469,0.669500531349628,4784,-0.423662770102728,35009,13450,3956,9150,9,35,0.294126394052045,0.680297397769517,5194,-0.386171003717472
NM,De Baca County,35011,192,617,903,0.212624584717608,0.68327796234773,425,-0.470653377630122,35011,900,287,586,11,35,0.318888888888889,0.651111111111111,299,-0.332222222222222
NM,Dona Ana County,35013,37543,25095,69324,0.541558479026023,0.361995845594599,12448,0.179562633431423,35013,65712,36778,26988,13,35,0.559684684684685,0.410701241782323,9790,0.148983442902362
NM,Eddy County,35015,5008,13124,19523,0.256517953183425,0.67223275111407,8116,-0.415714797930646,35015,19195,6110,12546,15,35,0.318312060432404,0.653607710341235,6436,-0.33529564990883
NM,Grant County,35017,6226,5251,12633,0.492836222591625,0.415657405208581,975,0.077178817383045,35017,12744,7009,5286,17,35,0.549984306340239,0.414783427495292,1723,0.135200878844947
NM,Guadalupe County,35019,962,591,1809,0.531785516860144,0.326699834162521,371,0.205085682697623,35019,1978,1388,518,19,35,0.701718907987867,0.261880687563195,870,0.439838220424671
NM,Harding County,35021,156,311,527,0.296015180265655,0.590132827324478,155,-0.294117647058823,35021,600,260,326,21,35,0.433333333333333,0.543333333333333,66,-0.11
NM,Hidalgo County,35023,780,906,1836,0.42483660130719,0.493464052287582,126,-0.068627450980392,35023,1929,994,895,23,35,0.515292897874546,0.463970969414204,99,0.051321928460342
NM,Lea County,35025,3877,12306,17369,0.223213771662157,0.708503655938741,8429,-0.485289884276585,35025,16933,4068,12480,25,35,0.240240949624993,0.737022382330361,8412,-0.496781432705368
NM,Lincoln County,35027,2329,5889,8856,0.262985546522132,0.664972899728997,3560,-0.401987353206865,35027,9209,2931,5940,27,35,0.318275599956564,0.645021174937561,3009,-0.326745574980997
NM,Los Alamos County,35028,5443,3329,10430,0.521860019175455,0.319175455417066,2114,0.202684563758389,35028,10654,5191,4796,28,35,0.487234841374132,0.450159564482823,395,0.037075276891309
NM,Luna County,35029,3195,3478,7245,0.440993788819876,0.480055210489993,283,-0.039061421670117,35029,7472,3573,3654,29,35,0.4781852248394,0.489025695931477,81,-0.010840471092077
NM,McKinley County,35031,13162,4893,20791,0.633062382761772,0.235342215381656,8269,0.397720167380116,35031,21313,15363,5420,31,35,0.720827663867123,0.254304884342889,9943,0.466522779524234
NM,Mora County,35033,1533,662,2429,0.631123919308357,0.272540139975299,871,0.358583779333059,35033,2604,1952,591,33,35,0.749615975422427,0.226958525345622,1361,0.522657450076805
NM,Otero County,35035,6033,11756,19636,0.307241800774088,0.598696272153188,5723,-0.2914544713791,35035,19643,6715,12219,35,35,0.341852059257751,0.62205365779158,5504,-0.280201598533829
NM,Quay County,35037,1016,2208,3550,0.286197183098592,0.621971830985915,1192,-0.335774647887324,35037,3696,1382,2194,37,35,0.373917748917749,0.593614718614719,812,-0.21969696969697
NM,Rio Arriba County,35039,9534,3583,14767,0.645628766844992,0.24263560641972,5951,0.402993160425273,35039,15239,11389,3373,39,35,0.747358750574185,0.221339982938513,8016,0.526018767635672
NM,Roosevelt County,35041,1445,3865,5855,0.246797608881298,0.660119555935098,2420,-0.4133219470538,35041,5949,1719,4032,41,35,0.288956127080182,0.677760968229955,2313,-0.388804841149773
NM,Sandoval County,35043,27405,25748,60597,0.452250111391653,0.424905523375745,1657,0.027344588015908,35043,53361,26831,24124,43,35,0.502820411911321,0.452090478064504,2707,0.050729933846817
NM,San Juan County,35045,12826,27879,45476,0.282038877649749,0.613048641041428,15053,-0.331009763391679,35045,45994,15688,28779,45,35,0.341087967995825,0.625712049397747,13091,-0.284624081401922
NM,San Miguel County,35047,7249,2302,10662,0.67989120240105,0.215906959294691,4947,0.463984243106359,35047,11388,8754,2281,47,35,0.768703898840885,0.200298559887601,6473,0.568405338953284
NM,Santa Fe County,35049,49956,14198,70082,0.712822122656317,0.202591250249707,35758,0.510230872406609,35049,67624,49668,15145,49,35,0.734472968176979,0.22395894948539,34523,0.510514018691589
NM,Sierra County,35051,1600,2998,5129,0.311951647494638,0.584519399493079,1398,-0.27256775199844,35051,5101,1963,2928,51,35,0.38482650460694,0.574005097039796,965,-0.189178592432856
NM,Socorro County,35053,3275,2592,6756,0.484754292480758,0.383658969804618,683,0.10109532267614,35053,7087,3983,2698,53,35,0.562014956963454,0.380697050938338,1285,0.181317906025116
NM,Taos County,35055,10550,2706,15072,0.699973460721868,0.17953821656051,7844,0.520435244161359,35055,15188,11855,2710,55,35,0.780550434553595,0.178430339741902,9145,0.602120094811693
NM,Torrance County,35057,1770,3695,6250,0.2832,0.5912,1925,-0.308,35057,6376,2414,3521,57,35,0.378607277289837,0.552227101631117,1107,-0.17361982434128
NM,Union County,35059,318,1214,1688,0.188388625592417,0.719194312796209,896,-0.530805687203791,35059,1753,471,1231,59,35,0.268682258984598,0.702224757558471,760,-0.433542498573873
NM,Valencia County,35061,10810,13175,27350,0.395246800731262,0.481718464351006,2365,-0.086471663619744,35061,27647,13473,12788,61,35,0.487322313451731,0.462545664990777,685,0.024776648460954
NY,Albany County,36001,74775,44227,125644,0.595133870300213,0.35200248320652,30548,0.243131387093693,36001,125531,80891,42029,1,36,0.644390628609666,0.334809728274291,38862,0.309580900335375
NY,Allegany County,36003,4473,11712,17111,0.261410788381743,0.68447197709076,7239,-0.423061188709018,36003,15601,5658,9609,3,36,0.362669059675662,0.615922056278444,3951,-0.253252996602782
NY,Bronx County,36005,318403,34424,358857,0.88726985958195,0.095926789779773,283979,0.791343069802177,36005,316047,288378,26304,5,36,0.912452894664401,0.083228127462055,262074,0.829224767202346
NY,Broome County,36007,35212,38077,77657,0.453429826029849,0.490322829880114,2865,-0.036893003850265,36007,75244,38315,34878,7,36,0.509210036680666,0.463531975971506,3437,0.04567806070916
NY,Cattaraugus County,36009,8717,18668,28961,0.300990987880253,0.64459100169193,9951,-0.343600013811678,36009,27608,11695,15406,9,36,0.423609098811939,0.558026658939438,3711,-0.134417560127499
NY,Cayuga County,36011,12202,16194,30124,0.405059089098393,0.537578010888328,3992,-0.132518921789935,36011,26073,14162,11355,11,36,0.543167261151383,0.435507996778276,2807,0.107659264373106
NY,Chautauqua County,36013,17281,29418,49381,0.349952410846277,0.595735201798262,12137,-0.245782790951986,36013,48434,21815,25795,13,36,0.450406739067597,0.532580418714126,3980,-0.082173679646529
NY,Chemung County,36015,12394,19025,33195,0.373369483355927,0.573128483205302,6631,-0.199758999849375,36015,31981,15285,16207,15,36,0.477940026890966,0.506769644476408,922,-0.028829617585441
NY,Chenango County,36017,5943,11024,18113,0.328106884558052,0.608623640479214,5081,-0.280516755921162,36017,17655,8340,8933,17,36,0.472387425658454,0.505975644293401,593,-0.033588218634948
NY,Clinton County,36019,13446,13181,28378,0.473817746141377,0.464479526393685,265,0.009338219747692,36019,27622,17123,10054,19,36,0.619904424009847,0.363985229165158,7069,0.255919194844689
NY,Columbia County,36021,13123,12756,27255,0.481489634929371,0.468024215740231,367,0.01346541918914,36021,26008,14244,11194,21,36,0.547677637649954,0.43040602891418,3050,0.117271608735774
NY,Cortland County,36023,7976,9207,18424,0.432913590968302,0.499728614850195,1231,-0.066815023881893,36023,17698,9445,7886,23,36,0.533676121595661,0.445587071985535,1559,0.088089049610126
NY,Delaware County,36025,5825,11012,17778,0.327652154348071,0.619417257284284,5187,-0.291765102936213,36025,16916,7469,9085,25,36,0.441534641759281,0.537065500118231,1616,-0.09553085835895
NY,Dutchess County,36027,56874,58163,120199,0.473165334154194,0.483889217048395,1289,-0.010723882894201,36027,114142,59885,52320,27,36,0.524653501778486,0.458376408333479,7565,0.066277093445007
NY,Erie County,36029,192065,173817,383248,0.501150690936417,0.453536613367845,18248,0.047614077568572,36029,386665,220184,159678,29,36,0.569443833809628,0.412962124836745,60506,0.156481708972884
NY,Essex County,36031,6760,7275,15079,0.448305590556403,0.482459049008555,515,-0.034153458452152,36031,15577,8835,6495,31,36,0.567182384284522,0.416960903896771,2340,0.150221480387751
NY,Franklin County,36033,6517,7636,15148,0.430221811460259,0.504092949564299,1119,-0.07387113810404,36033,14537,9065,5248,33,36,0.623581206576322,0.361009836967737,3817,0.262571369608585
NY,Fulton County,36035,5805,12759,19563,0.296733629811379,0.65220058273271,6954,-0.355466952921331,36035,18040,7916,9811,35,36,0.43880266075388,0.543847006651885,1895,-0.105044345898004
NY,Genesee County,36037,6946,15986,24463,0.283939009933369,0.653476679066345,9040,-0.369537669132976,36037,23079,8886,13701,37,36,0.385025347718705,0.593656570908618,4815,-0.208631223189913
NY,Greene County,36039,6370,11546,18869,0.337590757326832,0.611903121522073,5176,-0.274312364195241,36039,18263,7911,9935,39,36,0.433170891967366,0.543996057602803,2024,-0.110825165635438
NY,Hamilton County,36041,752,1795,2688,0.279761904761905,0.667782738095238,1043,-0.388020833333333,36041,2655,955,1652,41,36,0.35969868173258,0.622222222222222,697,-0.262523540489642
NY,Herkimer County,36043,7289,15664,24261,0.300441037055356,0.645645274308561,8375,-0.345204237253205,36043,23290,10433,12389,43,36,0.44796049806784,0.531945040790039,1956,-0.083984542722199
NY,Jefferson County,36045,12289,19947,34263,0.358666783410676,0.582173189738202,7658,-0.223506406327525,36045,32051,15345,16279,45,36,0.478768213160276,0.507909269601572,934,-0.029141056441297
NY,Kings County,36047,595086,133653,746295,0.797387092235644,0.179088698168955,461433,0.618298394066689,36047,618035,503291,108630,47,36,0.81434061177765,0.175766744601843,394661,0.638573867175807
NY,Lewis County,36049,2828,6916,10312,0.274243599689682,0.670674941815361,4088,-0.396431342125679,36049,9481,4263,5083,49,36,0.449636114333931,0.536124881341631,820,-0.0864887670077
NY,Livingston County,36051,10478,19211,31363,0.334087938016134,0.612537065969454,8733,-0.278449127953321,36051,24606,10889,13210,51,36,0.442534341217589,0.536860928228887,2321,-0.094326587011298
NY,Madison County,36053,10548,14901,27392,0.385075934579439,0.543990946261682,4353,-0.158915011682243,36053,25865,12698,12611,53,36,0.490933694181326,0.487570075391456,87,0.00336361878987
NY,Monroe County,36055,174063,128871,320164,0.543668245024425,0.402515585762297,45192,0.141152659262128,36055,308925,178491,124769,55,36,0.57778101480942,0.403881200938739,53722,0.173899813870681
NY,Montgomery County,36057,5961,10579,17438,0.341839660511526,0.606663608211951,4618,-0.264823947700424,36057,16784,7881,8622,57,36,0.469554337464252,0.513703527168732,741,-0.044149189704481
NY,Nassau County,36059,307326,275479,599649,0.512509818243673,0.459400415909974,31847,0.053109402333699,36059,460824,243649,212882,59,36,0.528724632397618,0.461959446556603,30767,0.066765185841015
NY,New York County,36061,515481,58935,591368,0.87167550493094,0.099658757322006,456546,0.772016747608934,36061,496293,417861,72300,61,36,0.841964323494387,0.14568007205421,345561,0.696284251440178
NY,Niagara County,36063,32888,49223,86000,0.382418604651163,0.572360465116279,16335,-0.189941860465116,36063,82720,40862,40397,63,36,0.493979690522244,0.4883583172147,465,0.005621373307544
NY,Oneida County,36065,30749,48490,83876,0.366600696265916,0.578115313081215,17741,-0.211514616815299,36065,80429,37388,41639,65,36,0.464857203247585,0.517711273296945,4251,-0.05285407004936
NY,Onondaga County,36067,102915,78277,191962,0.536121732426209,0.407773413488086,24638,0.128348318938123,36067,188787,112664,72807,67,36,0.596778379867258,0.385656851372181,39857,0.211121528495076
NY,Ontario County,36069,20233,24343,47664,0.424492279288352,0.510720879489762,4110,-0.08622860020141,36069,44144,21285,21998,69,36,0.482171982602392,0.498323667995651,713,-0.016151685393258
NY,Orange County,36071,63037,72129,140753,0.447855463116239,0.512450889146235,9092,-0.064595426029996,36071,130494,67709,60984,71,36,0.518866767820743,0.467331831348568,6725,0.051534936472175
NY,Orleans County,36073,4327,11582,16722,0.258760913766296,0.692620499940199,7255,-0.433859586173903,36073,13756,5411,8076,73,36,0.39335562663565,0.587089270136668,2665,-0.193733643501018
NY,Oswego County,36075,15614,25870,44122,0.353882416934862,0.586328815556865,10256,-0.232446398622003,36075,41133,21733,18503,75,36,0.528359224953201,0.449833467045924,3230,0.078525757907277
NY,Otsego County,36077,9285,12284,23024,0.403274843641418,0.533530229325921,2999,-0.130255385684503,36077,21938,10975,10527,77,36,0.500273498039931,0.479852311058437,448,0.020421186981493
NY,Putnam County,36079,17363,25241,44186,0.392952518897388,0.571244285520301,7878,-0.178291766622912,36079,40883,17851,22436,79,36,0.436636254677983,0.548785558789717,4585,-0.112149304111734
NY,Queens County,36081,473389,138550,627021,0.754981093137231,0.220965486004456,334839,0.534015607132776,36081,507722,399970,103193,81,36,0.787773624148648,0.203247052520868,296777,0.58452657162778
NY,Rensselaer County,36083,30039,31933,65991,0.455198436150384,0.483899319604189,1894,-0.028700883453804,36083,63332,34713,27240,83,36,0.548111539190299,0.430114318196173,7473,0.117997220994126
NY,Richmond County,36085,67561,95612,167209,0.40405121733878,0.571811325945374,28051,-0.167760108606594,36085,135283,67524,66420,85,36,0.499131450367008,0.490970779772773,1104,0.008160670594236
NY,Rockland County,36087,63454,57148,123943,0.511961143428834,0.461082917147398,6306,0.050878226281436,36087,114500,60446,52936,87,36,0.527912663755459,0.462323144104803,7510,0.065589519650655
NY,St. Lawrence County,36089,14659,18450,35154,0.416993798714229,0.524833589349718,3791,-0.10783979063549,36089,34023,19574,13914,89,36,0.575316697528143,0.408958645622079,5660,0.166358051906064
NY,Saratoga County,36091,46546,51088,104089,0.447175013690207,0.490810748494077,4542,-0.04363573480387,36091,97502,48876,46829,91,36,0.501282024984103,0.480287583844434,2047,0.020994441139669
NY,Schenectady County,36093,30870,27268,61629,0.500900550065716,0.442454039494394,3602,0.058446510571322,36093,59614,33777,24608,93,36,0.566595095111886,0.412788942194787,9169,0.1538061529171
NY,Schoharie County,36095,3777,8173,12673,0.298035192929851,0.644914384912807,4396,-0.346879191982956,36095,11943,4862,6849,95,36,0.407100393535962,0.573474001507159,1987,-0.166373607971197
NY,Schuyler County,36097,2761,5179,8423,0.327792947880802,0.614864062685504,2418,-0.287071114804701,36097,7464,3354,3942,97,36,0.44935691318328,0.528135048231511,588,-0.078778135048232
NY,Seneca County,36099,5175,6719,12727,0.406615856054058,0.527932741415887,1544,-0.121316885361829,36099,12148,6526,5405,99,36,0.537207770826474,0.444929206453737,1121,0.092278564372736
NY,Steuben County,36101,11215,25091,38373,0.29226278894014,0.65387121152894,13876,-0.361608422588799,36101,35659,14586,20425,101,36,0.409041195771054,0.572786673770997,5839,-0.163745477999944
NY,Suffolk County,36103,276953,328403,625720,0.442614907626414,0.524840184107908,51450,-0.082225276481493,36103,540653,274830,259348,103,36,0.508329741997177,0.47969399966337,15482,0.028635742333808
NY,Sullivan County,36105,10983,14626,26509,0.414312120411936,0.551737145874986,3643,-0.13742502546305,36105,25322,13781,11148,105,36,0.54423031356133,0.44024958534081,2633,0.10398072822052
NY,Tioga County,36107,6852,12528,20556,0.333333333333333,0.609457092819615,5676,-0.276123759486281,36107,19977,8263,11278,107,36,0.413625669519948,0.564549231616359,3015,-0.150923562096411
NY,Tompkins County,36109,25555,9647,37747,0.677007444300209,0.255569979071184,15908,0.421437465229025,36109,35825,24447,10202,109,36,0.682400558269365,0.284773203070481,14245,0.397627355198883
NY,Ulster County,36111,40010,32962,77134,0.518707703477066,0.427334249487904,7048,0.091373453989162,36111,72193,43164,27340,111,36,0.597897303062624,0.378707076863408,15824,0.219190226199216
NY,Warren County,36113,11366,14284,27568,0.412289611143355,0.518136970400464,2918,-0.10584735925711,36113,26220,13112,12571,113,36,0.500076277650648,0.479443173150267,541,0.020633104500381
NY,Washington County,36115,8238,12770,22401,0.367751439667872,0.570063836435873,4532,-0.202312396768001,36115,21263,10596,10254,115,36,0.498330433146781,0.482246155293232,342,0.016084277853548
NY,Wayne County,36117,12378,21935,36598,0.338215203016558,0.599349691239959,9557,-0.2611344882234,36117,34127,15136,18315,117,36,0.443519793711724,0.536671843408445,3179,-0.093152049696721
NY,Westchester County,36119,245670,121643,378506,0.649051798386287,0.321376675666964,124027,0.327675122719323,36119,284731,171908,108707,119,36,0.603755825674057,0.38178842486417,63201,0.221967400809887
NY,Wyoming County,36121,3585,11884,16280,0.220208845208845,0.72997542997543,8299,-0.509766584766585,36121,15230,5224,9726,121,36,0.343007222586999,0.638608010505581,4502,-0.295600787918582
NY,Yates County,36123,3219,5180,8975,0.35866295264624,0.577158774373259,1961,-0.21849582172702,36123,8437,4021,4270,123,36,0.476591205404765,0.506104065426099,249,-0.029512860021335
NC,Alamance County,37001,29268,38235,69264,0.422557172557173,0.552018364518364,8967,-0.129461191961192,37001,66638,28341,37712,1,37,0.425297878087578,0.565923347039227,9371,-0.140625468951649
NC,Alexander County,37003,3750,13826,18011,0.208206096274499,0.767641996557659,10076,-0.55943590028316,37003,17060,4591,12207,3,37,0.269109026963658,0.715533411488863,7616,-0.446424384525205
NC,Alleghany County,37005,1300,3789,5214,0.249328730341389,0.726697353279632,2489,-0.477368622938243,37005,5025,1574,3378,5,37,0.313233830845771,0.672238805970149,1804,-0.359004975124378
NC,Anson County,37007,5785,4480,10394,0.556571098710795,0.431017894939388,1305,0.125553203771407,37007,11072,6894,4125,7,37,0.622651734104046,0.372561416184971,2769,0.250090317919075
NC,Ashe County,37009,3476,9353,13160,0.264133738601824,0.710714285714286,5877,-0.446580547112462,37009,12486,4100,8207,9,37,0.328367771904533,0.657296171712318,4107,-0.328928399807785
NC,Avery County,37011,1670,6226,8060,0.207196029776675,0.772456575682382,4556,-0.565260545905707,37011,7657,1861,5708,11,37,0.243045579208567,0.74546166906099,3847,-0.502416089852423
NC,Beaufort County,37013,8699,14478,23599,0.368617314292978,0.613500572058138,5779,-0.244883257765159,37013,23468,9399,13918,13,37,0.400502812340208,0.593062894153741,4519,-0.192560081813533
NC,Bertie County,37015,5837,3476,9380,0.62228144989339,0.370575692963753,2361,0.251705756929638,37015,9941,6537,3367,15,37,0.657579720350065,0.338698320088522,3170,0.318881400261543
NC,Bladen County,37017,7021,8511,15743,0.445975989328591,0.5406212284825,1490,-0.09464523915391,37017,16351,8277,7947,17,37,0.506207571402361,0.486025319552321,330,0.02018225185004
NC,Brunswick County,37019,23117,42440,67255,0.343721656382425,0.631031150100364,19323,-0.287309493717939,37019,56985,21932,34587,19,37,0.384873212248837,0.606949197157147,12655,-0.222075984908309
NC,Buncombe County,37021,74937,55339,134507,0.557123421085891,0.411420966938524,19598,0.145702454147368,37021,126201,70066,54429,21,37,0.555193698940579,0.431288183136425,15637,0.123905515804154
NC,Burke County,37023,10930,25741,37638,0.290398002019236,0.683909878314469,14811,-0.393511876295233,37023,36116,13577,22109,23,37,0.375927566729427,0.612166352862997,8532,-0.23623878613357
NC,Cabarrus County,37025,35048,53224,91002,0.385134392650711,0.584866266675458,18176,-0.199731874024747,37025,82445,32453,49125,25,37,0.393632118381952,0.595851779974528,16672,-0.202219661592577
NC,Caldwell County,37027,8403,26499,35747,0.235068677091784,0.741292975634319,18096,-0.506224298542535,37027,34338,10795,23069,27,37,0.314374745180267,0.671821305841924,12274,-0.357446560661658
NC,Camden County,37029,1266,3527,4939,0.256327191739218,0.714112168455153,2261,-0.457784976715934,37029,4520,1456,2995,29,37,0.32212389380531,0.662610619469027,1539,-0.340486725663717
NC,Carteret County,37031,9806,26228,36919,0.265608494271242,0.710420108887023,16422,-0.444811614615781,37031,35124,10197,24598,31,37,0.290314314998292,0.700318870288122,14401,-0.41000455528983
NC,Caswell County,37033,4549,5758,10515,0.432620066571564,0.547598668568711,1209,-0.114978601997147,37033,10736,5183,5471,33,37,0.48276825633383,0.509593889716841,288,-0.026825633383011
NC,Catawba County,37035,21050,48062,71065,0.296207697178639,0.676310420037993,27012,-0.380102722859354,37035,69102,23954,44386,35,37,0.346646985615467,0.642325837168244,20432,-0.295678851552777
NC,Chatham County,37037,20953,17012,39080,0.536156601842375,0.435312180143296,3941,0.100844421699079,37037,35157,18252,16578,37,37,0.519156924652274,0.471541940438604,1674,0.04761498421367
NC,Cherokee County,37039,2809,10711,13860,0.202669552669553,0.772799422799423,7902,-0.57012987012987,37039,12695,3339,9201,39,37,0.263016935801497,0.724773532886963,5862,-0.461756597085467
NC,Chowan County,37041,2965,3983,7108,0.417135621834553,0.560354530106922,1018,-0.143218908272369,37041,7424,3507,3872,41,37,0.472386853448276,0.521551724137931,365,-0.049164870689655
NC,Clay County,37043,1352,4395,5885,0.229736618521665,0.746813933729822,3043,-0.517077315208156,37043,5592,1573,3952,43,37,0.281294706723891,0.706723891273248,2379,-0.425429184549356
NC,Cleveland County,37045,14896,28394,44137,0.33749461902712,0.643315132428575,13498,-0.305820513401455,37045,42542,16734,25440,45,37,0.393352451694796,0.597997273282873,8706,-0.204644821588078
NC,Columbus County,37047,8991,14177,23472,0.383052147239264,0.603996250852079,5186,-0.220944103612815,37047,24017,10973,12863,47,37,0.456884706666112,0.535578964899863,1890,-0.078694258233751
NC,Craven County,37049,17481,27556,46231,0.37812290454457,0.59605026929982,10075,-0.217927364755251,37049,45585,18556,26654,49,37,0.407063727103214,0.584709882636832,8098,-0.177646155533619
NC,Cumberland County,37051,70523,50593,124402,0.56689603061044,0.406689603061044,19930,0.160206427549396,37051,126092,74991,50191,51,37,0.594732417599848,0.39805062969895,24800,0.196681787900898
NC,Currituck County,37053,2879,9070,12423,0.231747565000402,0.730097399983901,6191,-0.498349834983498,37053,11153,3521,7431,53,37,0.315699811709854,0.666278131444454,3910,-0.3505783197346
NC,Dare County,37055,7079,11283,19009,0.372402546162344,0.593560944815614,4204,-0.221158398653269,37055,17614,7258,10102,55,37,0.412058589758147,0.573521062790962,2844,-0.161462473032815
NC,Davidson County,37057,17328,52870,72013,0.240623220807354,0.734172996542291,35542,-0.493549775734937,37057,69994,20291,48935,57,37,0.289896276823728,0.699131354116067,28644,-0.409235077292339
NC,Davie County,37059,5228,15502,21350,0.244871194379391,0.726088992974239,10274,-0.481217798594848,37059,20418,5652,14568,59,37,0.276814575374669,0.713488098736409,8916,-0.43667352336174
NC,Duplin County,37061,8196,12151,20601,0.397844764817242,0.589825736614727,3955,-0.191980971797486,37061,20375,8923,11330,61,37,0.437938650306749,0.556073619631902,2407,-0.118134969325153
NC,Durham County,37063,118783,27879,150543,0.789030376703002,0.185189613598772,90904,0.603840763104229,37063,143828,109185,33326,63,37,0.759135912339739,0.231707317073171,75859,0.527428595266568
NC,Edgecombe County,37065,16152,8219,24653,0.655173812517746,0.333387417352858,7933,0.321786395164889,37065,26826,18249,8494,65,37,0.680272869604115,0.316633117125177,9755,0.363639752478938
NC,Forsyth County,37067,92488,74793,172509,0.5361343466138,0.43355998817453,17695,0.10257435843927,37067,172332,91606,79177,67,37,0.531566975373117,0.459444560499501,12429,0.072122414873616
NC,Franklin County,37069,12811,16320,29902,0.428432880743763,0.545782890776537,3509,-0.117350010032774,37069,28059,13317,14480,69,37,0.474607077942906,0.516055454577854,1163,-0.041448376634948
NC,Gaston County,37071,30982,61467,94872,0.326566320937684,0.647894004553504,30485,-0.321327683615819,37071,89638,32903,55817,71,37,0.367065307124211,0.622693500524331,22914,-0.25562819340012
NC,Gates County,37073,2371,2851,5328,0.445007507507508,0.535097597597598,480,-0.09009009009009,37073,5310,2745,2532,73,37,0.516949152542373,0.47683615819209,213,0.040112994350283
NC,Graham County,37075,761,3260,4094,0.185881778212018,0.79628724963361,2499,-0.610405471421593,37075,3910,1115,2743,75,37,0.285166240409207,0.70153452685422,1628,-0.416368286445013
NC,Granville County,37077,12827,13500,26920,0.47648588410104,0.50148588410104,673,-0.025,37077,26068,13529,12332,77,37,0.51898879852693,0.473070431179991,1197,0.045918367346939
NC,Greene County,37079,3570,4358,8013,0.445526020217147,0.54386621739673,788,-0.098340197179583,37079,8194,3761,4393,79,37,0.458994386136197,0.536123993165731,632,-0.077129607029534
NC,Guilford County,37081,147949,97461,252087,0.586896587289309,0.386616525247236,50488,0.200280062042073,37081,251529,145483,103964,81,37,0.578394538999479,0.413328085429513,41519,0.165066453569966
NC,Halifax County,37083,15642,8954,24881,0.628672481009606,0.359872995458382,6688,0.268799485551224,37083,25724,16931,8686,83,37,0.658179132327787,0.337661327942777,8245,0.32051780438501
NC,Harnett County,37085,16452,27278,44955,0.365965965965966,0.606784562340118,10826,-0.240818596374152,37085,42343,16858,25070,85,37,0.398129560966394,0.592069527430744,8212,-0.193939966464351
NC,Haywood County,37087,10414,18844,30156,0.345337577928107,0.624883936861653,8430,-0.279546358933546,37087,27679,11742,15553,87,37,0.424220528198273,0.561906138227537,3811,-0.137685610029264
NC,Henderson County,37089,19664,35535,56810,0.346136243619081,0.625506072874494,15871,-0.279369829255413,37089,51961,18519,32860,89,37,0.356401916822232,0.632397374954293,14341,-0.275995458132061
NC,Hertford County,37091,6886,3081,10100,0.681782178217822,0.305049504950495,3805,0.376732673267327,37091,10872,7815,3001,91,37,0.718818984547461,0.27603016924209,4814,0.442788815305372
NC,Hoke County,37093,9608,7676,17847,0.538353784949851,0.430100296968678,1932,0.108253487981173,37093,16800,9915,6721,93,37,0.590178571428571,0.400059523809524,3194,0.190119047619048
NC,Hyde County,37095,956,1275,2273,0.420589529256489,0.560932688077431,319,-0.140343158820941,37095,2358,1157,1183,95,37,0.490670059372349,0.501696352841391,26,-0.011026293469042
NC,Iredell County,37097,24441,54164,80727,0.302761157976885,0.670952717182603,29723,-0.368191559205718,37097,75762,25952,49071,97,37,0.342546395290515,0.647699374356538,23119,-0.305152979066022
NC,Jackson County,37099,7564,9706,18004,0.420128860253277,0.53910242168407,2142,-0.118973561430793,37099,16556,8052,8224,99,37,0.486349359748732,0.49673834259483,172,-0.010388982846098
NC,Johnston County,37101,28153,54082,84553,0.332962757087271,0.639622485305075,25929,-0.306659728217804,37101,76021,27052,48206,101,37,0.355849041712158,0.634114257902422,21154,-0.278265216190263
NC,Jones County,37103,2041,2941,5039,0.405040682675134,0.583647549116888,900,-0.178606866441754,37103,5192,2335,2825,103,37,0.449730354391371,0.544106317411402,490,-0.094375963020031
NC,Lee County,37105,10380,13625,24676,0.420651645323391,0.552155940995299,3245,-0.131504295671908,37105,23800,10577,13000,105,37,0.444411764705882,0.546218487394958,2423,-0.101806722689076
NC,Lenoir County,37107,11752,13354,25500,0.460862745098039,0.523686274509804,1602,-0.062823529411765,37107,27247,13350,13763,107,37,0.489962197673138,0.505119829706023,413,-0.015157632032884
NC,Lincoln County,37109,9836,28653,39449,0.249334583893128,0.726330198484119,18817,-0.476995614590991,37109,36532,10980,25184,109,37,0.300558414540677,0.689368225117705,14204,-0.388809810577028
NC,McDowell County,37111,4645,14517,19557,0.237510865674694,0.742291762540267,9872,-0.504780896865572,37111,17953,6006,11732,111,37,0.33454018826937,0.653484097365343,5726,-0.318943909095973
NC,Macon County,37113,4841,12035,17336,0.279245500692201,0.694220119981541,7194,-0.41497461928934,37113,16750,5692,10817,113,37,0.339820895522388,0.645791044776119,5125,-0.305970149253731
NC,Madison County,37115,3899,6735,10966,0.355553529089914,0.614171074229436,2836,-0.258617545139522,37115,10023,4466,5379,115,37,0.445575177092687,0.536665668961389,913,-0.091090491868702
NC,Martin County,37117,5814,5874,11852,0.490550118123523,0.495612554843064,60,-0.005062436719541,37117,12541,6514,5963,117,37,0.519416314488478,0.475480424208596,551,0.043935890279882
NC,Mecklenburg County,37119,292258,154303,461834,0.632820450638108,0.334109225392674,137955,0.298711225245435,37119,445062,270705,170490,119,37,0.608241098992949,0.383070223923858,100215,0.225170875069091
NC,Mitchell County,37121,1585,6225,7948,0.199421238047307,0.783215903371918,4640,-0.58379466532461,37121,7673,1810,5778,121,37,0.235892089143751,0.753030105564968,3968,-0.517138016421217
NC,Montgomery County,37123,4108,7070,11449,0.358808629574635,0.617521180889161,2962,-0.258712551314525,37123,11178,4689,6389,123,37,0.419484702093398,0.571569153694758,1700,-0.15208445160136
NC,Moore County,37125,16148,30273,47746,0.338206341892515,0.634042642315587,14125,-0.295836300423072,37125,46044,16371,29336,125,37,0.355551211884285,0.637129702024151,12965,-0.281578490139866
NC,Nash County,37127,23024,23142,46903,0.490885444427862,0.49340127497175,118,-0.002515830543888,37127,48235,24214,23769,127,37,0.502000621955012,0.492774955944853,445,0.009225666010159
NC,New Hanover County,37129,50219,54665,108737,0.461839116400121,0.502726762739454,4446,-0.040887646339333,37129,102067,48038,52792,129,37,0.470651630791539,0.517228879069631,4754,-0.046577248278092
NC,Northampton County,37131,6113,3556,9761,0.626267800430284,0.364306935764778,2557,0.261960864665506,37131,10719,7210,3474,131,37,0.672637372889262,0.324097397145256,3736,0.348539975744006
NC,Onslow County,37133,17156,36342,55364,0.309876454013438,0.65641933386316,19186,-0.346542879849722,37133,50353,18115,31695,133,37,0.359760093738208,0.629456040355093,13580,-0.269695946616885
NC,Orange County,37135,59105,18373,79830,0.740385819867218,0.230151572090693,40732,0.510234247776525,37135,75848,53404,21398,135,37,0.70409239531695,0.282116865309566,32006,0.421975530007383
NC,Pamlico County,37137,2427,4225,6772,0.35838747784997,0.623892498523331,1798,-0.265505020673361,37137,6712,2632,4032,137,37,0.392133492252682,0.600715137067938,1400,-0.208581644815256
NC,Pasquotank County,37139,8455,8082,16964,0.49840839424664,0.476420655505777,373,0.021987738740863,37139,17343,9970,7216,139,37,0.57487170616387,0.416075650118203,2754,0.158796056045667
NC,Pender County,37141,9086,17317,27072,0.335623522458629,0.639664598108747,8231,-0.304041075650118,37141,24036,9455,14368,141,37,0.393368280911965,0.597770011649193,4913,-0.204401730737227
NC,Perquimans County,37143,2291,4143,6595,0.347384382107657,0.628203184230478,1852,-0.28081880212282,37143,6621,2747,3814,143,37,0.414892010270352,0.576045914514424,1067,-0.161153904244072
NC,Person County,37145,7772,11116,19303,0.402631715277418,0.575869035901155,3344,-0.173237320623737,37145,19008,8384,10467,145,37,0.441077441077441,0.550662878787879,2083,-0.109585437710438
NC,Pitt County,37147,40967,35191,78264,0.523446284370847,0.449644791986098,5776,0.073801492384749,37147,76814,40701,35534,147,37,0.529864347644961,0.462597963912828,5167,0.067266383732132
NC,Polk County,37149,3715,6738,10723,0.346451552737107,0.62836892660636,3023,-0.281917373869253,37149,10323,4000,6219,149,37,0.387484258452,0.602441150828248,2219,-0.214956892376247
NC,Randolph County,37151,13074,49156,63615,0.205517566611648,0.772710838638686,36082,-0.567193272027038,37151,60202,14675,44913,151,37,0.24376266569217,0.746038337596757,30238,-0.502275671904588
NC,Richmond County,37153,8290,10199,18813,0.440652740126508,0.542125126242492,1909,-0.101472386115984,37153,19127,9747,9236,153,37,0.509593767971977,0.48287760757045,511,0.026716160401527
NC,Robeson County,37155,18377,20294,39454,0.465782937091296,0.514371166421656,1917,-0.048588229330359,37155,41380,23957,17093,155,37,0.578951184146931,0.413073948767521,6864,0.16587723537941
NC,Rockingham County,37157,14057,26463,41374,0.339754435152511,0.639604582588099,12406,-0.299850147435588,37157,41549,16170,25037,157,37,0.389179041613517,0.602589713350502,8867,-0.213410671736985
NC,Rowan County,37159,19208,42388,63078,0.304511874187514,0.671993404990647,23180,-0.367481530803133,37159,61803,22529,38622,159,37,0.364529229972655,0.624921120333964,16093,-0.260391890361309
NC,Rutherford County,37161,7451,21694,29764,0.250335976347265,0.728867087757022,14243,-0.478531111409757,37161,28373,9277,18797,161,37,0.326965777323512,0.662496034962817,9520,-0.335530257639305
NC,Sampson County,37163,10486,14761,25638,0.409002262266947,0.5757469381387,4275,-0.166744675871753,37163,26005,11496,14358,163,37,0.442068832916747,0.552124591424726,2862,-0.110055758507979
NC,Scotland County,37165,7279,6212,13743,0.529651458924543,0.452011933347886,1067,0.077639525576657,37165,14020,8131,5799,165,37,0.579957203994294,0.413623395149786,2332,0.166333808844508
NC,Stanly County,37167,7008,21788,29451,0.23795456860548,0.739805099996604,14780,-0.501850531391124,37167,28276,8287,19698,167,37,0.293075399632197,0.696633187155185,11411,-0.403557787522988
NC,Stokes County,37169,4645,16976,22182,0.209404021278514,0.765305202416374,12331,-0.55590118113786,37169,21396,5969,15142,169,37,0.278977378949336,0.707702374275566,9173,-0.428724995326229
NC,Surry County,37171,7438,23495,31663,0.234911410794934,0.742033288064934,16057,-0.50712187727,37171,29096,9005,19753,171,37,0.309492713775089,0.678890569150399,10748,-0.369397855375309
NC,Swain County,37173,2186,3557,5982,0.365429622199933,0.594617184887997,1371,-0.229187562688064,37173,5705,2618,2976,173,37,0.458895705521472,0.521647677475898,358,-0.062751971954426
NC,Transylvania County,37175,6520,10441,17440,0.373853211009174,0.59868119266055,3921,-0.224827981651376,37175,16469,6740,9522,175,37,0.409253749468699,0.578177181371061,2782,-0.168923431902362
NC,Tyrrell County,37177,705,968,1700,0.414705882352941,0.569411764705882,263,-0.154705882352941,37177,1775,835,929,177,37,0.470422535211268,0.523380281690141,94,-0.052957746478873
NC,Union County,37179,34051,66265,103596,0.328690296922661,0.639648248967142,32214,-0.310957952044481,37179,93389,32032,60468,179,37,0.342995427727034,0.647485249868828,28436,-0.304489822141794
NC,Vance County,37181,12168,7304,19762,0.615727153122154,0.369598218803765,4864,0.246128934318389,37181,20770,13286,7406,181,37,0.639672604718344,0.356571978815599,5880,0.283100625902744
NC,Wake County,37183,298353,193607,510940,0.583929619916233,0.378923161232239,104746,0.205006458683994,37183,526805,286939,232933,183,37,0.544677821964484,0.442161710689914,54006,0.10251611127457
NC,Warren County,37185,6668,3302,10123,0.658698014422602,0.326187888965722,3366,0.33251012545688,37185,9777,6635,3111,185,37,0.678633527666973,0.318195765572261,3524,0.360437762094712
NC,Washington County,37187,3490,2560,6115,0.570727718724448,0.418642681929681,930,0.152085036794767,37187,6456,3811,2615,187,37,0.590303593556382,0.405049566294919,1196,0.185254027261462
NC,Watauga County,37189,13953,13521,28769,0.485001216587299,0.469985053356043,432,0.015016163231256,37189,28168,13371,14124,189,37,0.474687588753195,0.50142005112184,753,-0.026732462368645
NC,Wayne County,37191,21520,27360,49824,0.431920359666024,0.549132947976879,5840,-0.117212588310854,37191,50988,23154,27536,191,37,0.454106848670275,0.540048638895426,4382,-0.085941790225151
NC,Wilkes County,37193,6596,23613,30844,0.213850343664894,0.76556218389314,17017,-0.551711840228245,37193,28852,8089,20410,193,37,0.280361846665742,0.707403299597948,12321,-0.427041452932206
NC,Wilson County,37195,19527,17410,37593,0.519431809113399,0.463118133695103,2117,0.056313675418296,37195,38890,20745,17904,195,37,0.533427616353818,0.460375417845204,2841,0.073052198508614
NC,Yadkin County,37197,3140,13815,17350,0.180979827089337,0.796253602305475,10675,-0.615273775216138,37197,16657,3928,12500,197,37,0.235816773728763,0.750435252446419,8572,-0.514618478717656
NC,Yancey County,37199,3181,6367,9808,0.324327079934747,0.649163947797716,3186,-0.324836867862969,37199,9344,3954,5249,199,37,0.423159246575342,0.561750856164384,1295,-0.138591609589041
ND,Adams County,38001,216,904,1206,0.17910447761194,0.749585406301824,688,-0.570480928689884,38001,1281,328,916,1,38,0.256049960967994,0.715066354410617,588,-0.459016393442623
ND,Barnes County,38003,1597,3156,5253,0.304016752332001,0.600799543118218,1559,-0.296782790786217,38003,5471,2389,2953,3,38,0.43666605739353,0.539755072198867,564,-0.103089014805337
ND,Benson County,38005,842,927,1940,0.434020618556701,0.477835051546392,85,-0.043814432989691,38005,2148,1232,867,5,38,0.573556797020484,0.403631284916201,365,0.169925512104283
ND,Billings County,38007,58,492,592,0.097972972972973,0.831081081081081,434,-0.733108108108108,38007,577,89,472,7,38,0.154246100519931,0.818024263431542,383,-0.663778162911612
ND,Bottineau County,38009,734,2482,3437,0.213558335757928,0.722141402385802,1748,-0.508583066627873,38009,3484,1163,2246,9,38,0.333811710677382,0.644661308840413,1083,-0.310849598163031
ND,Bowman County,38011,227,1445,1769,0.12832108535896,0.816845675522894,1218,-0.688524590163935,38011,1728,412,1277,11,38,0.238425925925926,0.73900462962963,865,-0.500578703703704
ND,Burke County,38013,118,879,1031,0.114451988360815,0.852570320077595,761,-0.73811833171678,38013,1015,230,766,13,38,0.226600985221675,0.754679802955665,536,-0.52807881773399
ND,Burleigh County,38015,10865,32499,46874,0.23179161155438,0.693326790971541,21634,-0.461535179417161,38015,42876,14036,27811,15,38,0.327362627110738,0.64863793264297,13775,-0.321275305532232
ND,Cass County,38017,31291,39738,78807,0.397058636923116,0.504244546804218,8447,-0.107185909881102,38017,73275,34632,36792,17,38,0.472630501535312,0.502108495394063,2160,-0.029477993858751
ND,Cavalier County,38019,476,1356,1969,0.241747079735907,0.688674454037583,880,-0.446927374301676,38019,2054,818,1192,19,38,0.398247322297955,0.58033106134372,374,-0.182083739045764
ND,Dickey County,38021,551,1656,2372,0.232293423271501,0.69814502529511,1105,-0.465851602023609,38021,2513,849,1601,21,38,0.337843215280541,0.637087146836451,752,-0.299243931555909
ND,Divide County,38023,243,860,1187,0.204717775905644,0.724515585509688,617,-0.519797809604044,38023,1151,382,731,23,38,0.331885317115552,0.635099913119027,349,-0.303214596003475
ND,Dunn County,38025,356,1753,2199,0.161891768985903,0.797180536607549,1397,-0.635288767621646,38025,2002,493,1494,25,38,0.246253746253746,0.746253746253746,1001,-0.5
ND,Eddy County,38027,354,790,1219,0.290401968826907,0.648072190319934,436,-0.357670221493027,38027,1147,484,631,27,38,0.421970357454228,0.550130775937228,147,-0.128160418482999
ND,Emmons County,38029,215,1672,1959,0.109749872383869,0.853496681980602,1457,-0.743746809596733,38029,1862,383,1430,29,38,0.205692803437164,0.767991407089151,1047,-0.562298603651987
ND,Foster County,38031,346,1237,1699,0.20364920541495,0.728075338434373,891,-0.524426133019423,38031,1674,604,1028,31,38,0.360812425328554,0.614097968936679,424,-0.253285543608124
ND,Golden Valley County,38033,99,793,942,0.105095541401274,0.841825902335457,694,-0.736730360934183,38033,924,161,740,33,38,0.174242424242424,0.800865800865801,579,-0.626623376623377
ND,Grand Forks County,38035,10828,16325,29711,0.364444145266063,0.549459796035139,5497,-0.185015650769075,38035,29796,14008,15044,35,38,0.470130218821318,0.504899986575379,1036,-0.034769767754061
ND,Grant County,38037,187,1098,1361,0.1373989713446,0.806759735488611,911,-0.669360764144012,38037,1383,331,1012,37,38,0.239334779464931,0.73174258857556,681,-0.492407809110629
ND,Griggs County,38039,298,847,1247,0.23897353648757,0.679230152365678,549,-0.440256615878108,38039,1335,535,770,39,38,0.400749063670412,0.576779026217228,235,-0.176029962546816
ND,Hettinger County,38041,168,1032,1261,0.133227597145123,0.818398096748612,864,-0.685170499603489,38041,1351,313,998,41,38,0.231680236861584,0.738712065136936,685,-0.507031828275352
ND,Kidder County,38043,179,1106,1358,0.131811487481591,0.814432989690721,927,-0.682621502209131,38043,1310,393,870,43,38,0.3,0.66412213740458,477,-0.36412213740458
ND,LaMoure County,38045,500,1475,2115,0.236406619385343,0.697399527186761,975,-0.460992907801418,38045,2179,737,1374,45,38,0.338228545204222,0.630564479118862,637,-0.29233593391464
ND,Logan County,38047,112,867,1030,0.10873786407767,0.841747572815534,755,-0.733009708737864,38047,1042,221,799,47,38,0.212092130518234,0.76679462571977,578,-0.554702495201535
ND,McHenry County,38049,474,1991,2687,0.176404912541868,0.740975065128396,1517,-0.564570152586528,38049,2653,924,1651,49,38,0.348284960422164,0.622314361100641,727,-0.274029400678477
ND,McIntosh County,38051,233,1095,1423,0.163738580463809,0.769501054111033,862,-0.605762473647224,38051,1510,456,1028,51,38,0.301986754966887,0.680794701986755,572,-0.378807947019868
ND,McKenzie County,38053,696,3661,4594,0.151501959077057,0.796909011754462,2965,-0.645407052677405,38053,3423,926,2450,53,38,0.27052293309962,0.715746421267894,1524,-0.445223488168274
ND,McLean County,38055,1070,3827,5206,0.20553207837111,0.735113330772186,2757,-0.529581252401076,38055,4894,1660,3130,55,38,0.339190845933796,0.639558643236616,1470,-0.30036779730282
ND,Mercer County,38057,616,3715,4564,0.134969325153374,0.813978965819457,3099,-0.679009640666082,38057,4394,1161,3132,57,38,0.264223941738735,0.71279016841147,1971,-0.448566226672735
ND,Morton County,38059,3077,11319,15547,0.197915996655303,0.728050427735254,8242,-0.530134431079951,38059,13510,4467,8669,59,38,0.330643967431532,0.641672834937084,4202,-0.311028867505551
ND,Mountrail County,38061,1211,2551,4009,0.302070341731105,0.636318283861312,1340,-0.334247942130207,38061,3444,1401,1960,61,38,0.406794425087108,0.569105691056911,559,-0.162311265969803
ND,Nelson County,38063,536,1025,1694,0.316410861865407,0.605076741440378,489,-0.28866587957497,38063,1668,766,862,63,38,0.459232613908873,0.516786570743405,96,-0.057553956834532
ND,Oliver County,38065,119,827,1002,0.1187624750499,0.825349301397206,708,-0.706586826347305,38065,1010,281,693,65,38,0.278217821782178,0.686138613861386,412,-0.407920792079208
ND,Pembina County,38067,681,2204,3093,0.220174587778855,0.712576786291626,1523,-0.492402198512771,38067,3226,1245,1893,67,38,0.385926844389337,0.586794792312461,648,-0.200867947923125
ND,Pierce County,38069,431,1433,2020,0.213366336633663,0.709405940594059,1002,-0.496039603960396,38069,2162,656,1462,69,38,0.303422756706753,0.67622571692877,806,-0.372802960222017
ND,Ramsey County,38071,1505,3216,5218,0.288424683786891,0.616328095055577,1711,-0.327903411268685,38071,4971,2162,2659,71,38,0.434922550794609,0.534902434117884,497,-0.099979883323275
ND,Ransom County,38073,836,1209,2317,0.360811394044023,0.521795425118688,373,-0.160984031074665,38073,2412,1341,1008,73,38,0.555970149253731,0.417910447761194,333,0.138059701492537
ND,Renville County,38075,200,978,1255,0.159362549800797,0.779282868525896,778,-0.6199203187251,38075,1272,398,850,75,38,0.312893081761006,0.668238993710692,452,-0.355345911949686
ND,Richland County,38077,2064,4759,7460,0.276675603217158,0.637935656836461,2695,-0.361260053619303,38077,7549,3190,4213,77,38,0.422572526162406,0.558087163862763,1023,-0.135514637700358
ND,Rolette County,38079,2097,1210,3662,0.572637902785363,0.330420535226652,887,0.242217367558711,38079,4528,3351,1090,79,38,0.74006183745583,0.240724381625442,2261,0.499337455830389
ND,Sargent County,38081,693,1088,1978,0.350353892821031,0.55005055611729,395,-0.199696663296259,38081,1987,1073,876,81,38,0.540010065425264,0.440865626572723,197,0.099144438852542
ND,Sheridan County,38083,94,644,774,0.121447028423773,0.83204134366925,550,-0.710594315245478,38083,808,161,637,83,38,0.199257425742574,0.788366336633663,476,-0.589108910891089
ND,Sioux County,38085,758,256,1177,0.644010195412065,0.21750212404418,502,0.426508071367884,38085,1138,900,223,85,38,0.790861159929701,0.195957820738137,677,0.594903339191564
ND,Slope County,38087,42,361,427,0.098360655737705,0.845433255269321,319,-0.747072599531616,38087,434,83,341,87,38,0.191244239631336,0.785714285714286,258,-0.594470046082949
ND,Stark County,38089,1745,9718,12115,0.144036318613289,0.802146099876187,7973,-0.658109781262897,38089,11539,2805,8509,89,38,0.243088655862726,0.737412254094809,5704,-0.494323598232082
ND,Steele County,38091,361,537,984,0.366869918699187,0.545731707317073,176,-0.178861788617886,38091,1028,515,495,91,38,0.500972762645914,0.481517509727627,20,0.019455252918288
ND,Stutsman County,38093,2484,6706,9938,0.249949688066009,0.67478365868384,4222,-0.424833970617831,38093,9431,3561,5641,93,38,0.377584561552327,0.598133814017602,2080,-0.220549252465274
ND,Towner County,38095,305,733,1137,0.268249780123131,0.644678979771328,428,-0.376429199648197,38095,1164,511,619,95,38,0.439003436426117,0.531786941580756,108,-0.092783505154639
ND,Traill County,38097,1239,2263,3864,0.320652173913043,0.585662525879917,1024,-0.265010351966874,38097,3841,1784,1963,97,38,0.464462379588649,0.511064826868003,179,-0.046602447279354
ND,Walsh County,38099,1166,2991,4543,0.256658595641646,0.658375522782302,1825,-0.401716927140656,38099,5061,2118,2809,99,38,0.418494368701838,0.555028650464335,691,-0.136534281762498
ND,Ward County,38101,5792,18601,26861,0.215628606529913,0.692490972041249,12809,-0.476862365511336,38101,25231,8412,16176,101,38,0.333399389639729,0.64111608735286,7764,-0.307716697713131
ND,Wells County,38103,419,1793,2352,0.178146258503401,0.762329931972789,1374,-0.584183673469388,38103,2359,671,1646,103,38,0.284442560406952,0.697753285290377,975,-0.413310724883425
ND,Williams County,38105,1722,10033,12529,0.137441136563173,0.800782185330034,8311,-0.663341048766861,38105,9600,2288,7087,105,38,0.238333333333333,0.738229166666667,4799,-0.499895833333333
OH,Adams County,39001,2293,8445,11063,0.207267468137033,0.76335532857272,6152,-0.556087860435687,39001,10787,3857,6691,1,39,0.357560025957171,0.620283674793733,2834,-0.262723648836563
OH,Allen County,39003,12815,29858,44636,0.287100098575141,0.668921946410969,17043,-0.381821847835828,39003,46458,16869,28802,3,39,0.363102156786775,0.619957811356494,11933,-0.256855654569719
OH,Ashland County,39005,5659,17169,24074,0.235066877128853,0.713176040541663,11510,-0.478109163412811,39005,23826,8083,15225,5,39,0.339251238143205,0.639007806597834,7142,-0.299756568454629
OH,Ashtabula County,39007,15191,22755,39809,0.381597126277977,0.571604411062825,7564,-0.190007284784848,39007,41781,22964,17890,7,39,0.549627821258467,0.428185060194825,5074,0.121442761063641
OH,Athens County,39009,15552,10816,27941,0.556601410114169,0.387101392219319,4736,0.16950001789485,39009,26112,17268,8118,9,39,0.661305147058823,0.310891544117647,9150,0.350413602941176
OH,Auglaize County,39011,3825,18130,22860,0.167322834645669,0.793088363954506,14305,-0.625765529308836,39011,22838,5643,16802,11,39,0.247088186356073,0.73570365180839,11159,-0.488615465452316
OH,Belmont County,39013,8652,20729,30537,0.283328421259456,0.678815862723909,12077,-0.395487441464453,39013,30876,13826,16418,13,39,0.447791164658635,0.531739862676513,2592,-0.083948698017878
OH,Brown County,39015,4270,14257,19139,0.223104655415643,0.744918752285908,9987,-0.521814096870265,39015,18955,6923,11671,15,39,0.365233447639145,0.615721445528884,4748,-0.250487997889739
OH,Butler County,39017,56700,104441,168422,0.336654356319246,0.62011494935341,47741,-0.283460593034164,39017,164020,59282,102226,17,39,0.36143153273991,0.623253261797342,42944,-0.261821729057432
OH,Carroll County,39019,3124,9067,12807,0.243929101272741,0.707972202701648,5943,-0.464043101428906,39019,12965,5396,7177,19,39,0.416197454685692,0.553567296567682,1781,-0.13736984188199
OH,Champaign County,39021,4488,12314,17597,0.255043473319316,0.699778371313292,7826,-0.444734897993976,39021,20016,7826,11852,21,39,0.390987210231815,0.592126298960831,4026,-0.201139088729017
OH,Clark County,39023,22666,34311,59620,0.380174438108017,0.57549480040255,11645,-0.195320362294532,39023,62136,30022,31116,23,39,0.483165958542552,0.500772499034376,1094,-0.017606540491825
OH,Clermont County,39025,26096,65960,96455,0.270551034161008,0.68384220621015,39864,-0.413291172049142,39025,93392,29334,62527,25,39,0.314095425732397,0.669511307178345,33193,-0.355415881445948
OH,Clinton County,39027,3943,13466,18100,0.217845303867403,0.743977900552486,9523,-0.526132596685083,39027,17648,5534,11740,27,39,0.313576609247507,0.665231187669991,6206,-0.351654578422484
OH,Columbiana County,39029,12273,31086,45261,0.271160601842646,0.686816464505866,18813,-0.41565586266322,39029,45078,19351,24778,29,39,0.429278140112694,0.549669461821731,5427,-0.120391321709038
OH,Coshocton County,39031,3908,10381,14961,0.261212485796404,0.693870730566139,6473,-0.432658244769735,39031,15555,6841,8312,31,39,0.439794278367085,0.534361941497911,1471,-0.094567663130826
OH,Crawford County,39033,4518,13265,18702,0.24157844080847,0.709282429686665,8747,-0.467703988878195,39033,19192,7207,11561,33,39,0.375521050437682,0.602386411004585,4354,-0.226865360566903
OH,Cuyahoga County,39035,383974,179894,583230,0.658357766232876,0.308444352999674,204080,0.349913413233201,39035,611512,420953,184475,35,39,0.688380604141865,0.301670286110493,236478,0.386710318031371
OH,Darke County,39037,4395,19698,25000,0.1758,0.78792,15303,-0.61212,39037,24807,6610,17745,37,39,0.266457048413754,0.715322288063853,11135,-0.448865239650099
OH,Defiance County,39039,5282,11478,17795,0.296824950828884,0.645012644001124,6196,-0.348187693172239,39039,17744,7438,9935,39,39,0.419183949504058,0.559907574391344,2497,-0.140723624887286
OH,Delaware County,39041,39584,55660,100101,0.395440604988961,0.556038401214773,16076,-0.160597796225812,39041,96330,36131,58980,41,39,0.375075262119796,0.612270320772345,22849,-0.237195058652549
OH,Erie County,39043,15692,19301,36730,0.427225701061802,0.525483256193847,3609,-0.098257555132045,39043,38262,20969,16655,43,39,0.548037217082223,0.435288275573676,4314,0.112748941508546
OH,Fairfield County,39045,24150,43163,70542,0.342349238751382,0.61187661251453,19013,-0.269527373763148,39045,70079,28831,40134,45,39,0.41140712624324,0.572696528203884,11303,-0.161289401960644
OH,Fayette County,39047,2672,7763,10817,0.247018581861884,0.717666635850975,5091,-0.470648053989091,39047,10677,4075,6456,47,39,0.38166151540695,0.604664231525709,2381,-0.22300271611876
OH,Franklin County,39049,335961,192328,554711,0.605650509905158,0.346717479912964,143633,0.258933029992194,39049,541751,325654,207941,49,39,0.601113795821328,0.383831317339516,117713,0.217282478481812
OH,Fulton County,39051,5981,13419,20693,0.289034939351471,0.64848016237375,7438,-0.359445223022278,39051,20757,8790,11521,51,39,0.423471599942188,0.555041672688732,2731,-0.131570072746543
OH,Gallia County,39053,2564,9567,12588,0.203686050206546,0.760009532888465,7003,-0.556323482681919,39053,9534,3418,5912,53,39,0.358506398153975,0.620096496748479,2494,-0.261590098594504
OH,Geauga County,39055,17165,29577,48736,0.352203709783322,0.606881976362443,12412,-0.25467826657912,39055,50125,19295,30104,55,39,0.384937655860349,0.60057855361596,10809,-0.215640897755611
OH,Greene County,39057,28023,47506,79633,0.351901849735662,0.596561726922256,19483,-0.244659877186593,39057,81075,31028,48683,57,39,0.382707369719396,0.600468701819303,17655,-0.217761332099907
OH,Guernsey County,39059,4286,11164,16156,0.265288437732112,0.691012626887843,6878,-0.425724189155732,39059,16403,7226,8811,59,39,0.44052917149302,0.53715783698104,1585,-0.096628665488021
OH,Hamilton County,39061,207587,169972,395000,0.52553670886076,0.430308860759494,37615,0.095227848101266,39061,402572,208508,188653,61,39,0.517939648062955,0.468619278042189,19855,0.049320370020767
OH,Hancock County,39063,9419,23777,35216,0.267463652885052,0.675176056338028,14358,-0.407712403452976,39063,34940,12192,22077,63,39,0.348941041785919,0.631854607899256,9885,-0.282913566113337
OH,Hardin County,39065,2870,8541,12014,0.238887964041951,0.710920592641918,5671,-0.472032628599967,39065,12147,4487,7337,65,39,0.369391619329876,0.604017452869021,2850,-0.234625833539145
OH,Harrison County,39067,1663,5021,6956,0.239074180563542,0.721822886716504,3358,-0.482748706152962,39067,6999,2895,3936,67,39,0.413630518645521,0.562366052293185,1041,-0.148735533647664
OH,Henry County,39069,3690,9136,13671,0.269914417379855,0.668275912515544,5446,-0.398361495135689,39069,13937,5513,8111,69,39,0.395565760206644,0.581976035014709,2598,-0.186410274808065
OH,Highland County,39071,3436,13005,17048,0.201548568747067,0.762846081651807,9569,-0.561297512904739,39071,17161,5772,11032,71,39,0.336344035895344,0.642852980595536,5260,-0.306508944700192
OH,Hocking County,39073,3713,8282,12513,0.296731399344681,0.66187165348038,4569,-0.365140254135699,39073,12442,6010,6150,73,39,0.483041311686224,0.49429352194181,140,-0.011252210255586
OH,Holmes County,39075,1766,8578,10823,0.163171024669685,0.792571375773815,6812,-0.62940035110413,39075,11355,2568,8563,75,39,0.226155878467635,0.754117129018054,5995,-0.527961250550418
OH,Huron County,39077,7080,15930,24332,0.290974847936873,0.654693407857965,8850,-0.363718559921092,39077,24077,10673,12821,77,39,0.443286123686506,0.532499896166466,2148,-0.08921377247996
OH,Jackson County,39079,3142,9618,13239,0.237329103406602,0.72648991615681,6476,-0.489160812750208,39079,12916,4965,7651,79,39,0.384406937132239,0.592366057602973,2686,-0.207959120470734
OH,Jefferson County,39081,9483,20668,31346,0.302526638167549,0.659350475339756,11185,-0.356823837172207,39081,32327,14960,16729,81,39,0.462771058248523,0.517493117208525,1769,-0.054722058960003
OH,Knox County,39083,7959,18563,27768,0.286624891961971,0.668503313166235,10604,-0.381878421204264,39083,27618,10154,16873,83,39,0.367658773263813,0.61094213918459,6719,-0.243283365920776
OH,Lake County,39085,45056,62627,112790,0.399468037946626,0.555253125277064,17571,-0.155785087330437,39085,114264,55219,57150,85,39,0.483258069033116,0.500157529930687,1931,-0.016899460897571
OH,Lawrence County,39087,6849,18240,25949,0.263940806967513,0.702917260780762,11391,-0.438976453813249,39087,25252,10454,14371,87,39,0.413987010929827,0.569103437351497,3917,-0.15511642642167
OH,Licking County,39089,26360,49346,79399,0.331994105719216,0.621493973475736,22986,-0.289499867756521,39089,77423,32264,43604,89,39,0.416723712591866,0.563191816385312,11340,-0.146468103793446
OH,Logan County,39091,4537,15586,21007,0.215975627171895,0.741943161803208,11049,-0.525967534631313,39091,20535,6789,13323,91,39,0.330606281957633,0.648794740686633,6534,-0.318188458728999
OH,Lorain County,39093,64958,65346,136654,0.475346495528854,0.478185783072578,388,-0.002839287543724,39093,138513,78112,58095,93,39,0.563932627262423,0.419419115895259,20017,0.144513511367164
OH,Lucas County,39095,107363,74102,191684,0.560104129713487,0.386584169779429,33261,0.173519959934058,39095,200850,129229,68100,95,39,0.643410505352253,0.339058999253174,61129,0.304351506099079
OH,Madison County,39097,4662,11319,16754,0.278261907604154,0.675599856750627,6657,-0.397337949146472,39097,17240,6700,10215,97,39,0.388631090487239,0.592517401392111,3515,-0.203886310904872
OH,Mahoning County,39099,56188,52808,112827,0.498001364921517,0.468043996561107,3380,0.02995736836041,39099,117571,74298,41702,99,39,0.631941550212212,0.354696311165168,32596,0.277245239047044
OH,Marion County,39101,7748,16563,25648,0.302089831565814,0.645781347473487,8815,-0.343691515907673,39101,26433,11933,13938,101,39,0.451443271667991,0.527295426171831,2005,-0.07585215450384
OH,Medina County,39103,31582,53811,89360,0.353424350940018,0.60218218442256,22229,-0.248757833482543,39103,88849,37841,49464,103,39,0.425902373690194,0.556719828022825,11623,-0.130817454332632
OH,Meigs County,39105,2157,6869,9410,0.229224229543039,0.729968119022317,4712,-0.500743889479277,39105,9979,3911,5782,105,39,0.391923038380599,0.579416775227979,1871,-0.187493736847379
OH,Mercer County,39107,3335,17200,21315,0.156462585034014,0.806943467041989,13865,-0.650480882007976,39107,21161,4609,16207,107,39,0.2178063418553,0.765890080809036,11598,-0.548083738953736
OH,Miami County,39109,12832,36311,51467,0.249324810072474,0.70552004196864,23479,-0.456195231896167,39109,50281,15731,33650,109,39,0.312861717149619,0.669238877508403,17919,-0.356377160358784
OH,Monroe County,39111,1647,4781,6686,0.24633562668262,0.715076278791505,3134,-0.468740652108884,39111,6743,3007,3540,111,39,0.445943941865639,0.524988877354293,533,-0.079044935488655
OH,Montgomery County,39113,117661,120766,249560,0.471473793877224,0.483915691617246,3105,-0.012441897740023,39113,254266,128983,121188,113,39,0.50727584498124,0.476618973830555,7795,0.030656871150685
OH,Morgan County,39115,1711,4315,6290,0.272019077901431,0.686009538950715,2604,-0.413990461049285,39115,6042,2772,3136,115,39,0.458788480635551,0.519033432638199,364,-0.060244952002648
OH,Morrow County,39117,3711,11722,16186,0.229272210552329,0.724206104040529,8011,-0.4949338934882,39117,15813,5780,9662,117,39,0.365522038828812,0.611016252450515,3882,-0.245494213621704
OH,Muskingum County,39119,10926,23588,36217,0.301681530772841,0.651296352541624,12662,-0.349614821768783,39119,35954,16327,18826,119,39,0.454108026923291,0.523613506146743,2499,-0.069505479223452
OH,Noble County,39121,1201,4441,5875,0.204425531914894,0.755914893617021,3240,-0.551489361702128,39121,5755,2082,3498,121,39,0.361772371850565,0.607819287576021,1416,-0.246046915725456
OH,Ottawa County,39123,8136,12389,21742,0.374206604728176,0.569818783920523,4253,-0.195612179192347,39123,21936,11214,10323,123,39,0.511214442013129,0.470596280087527,891,0.040618161925602
OH,Paulding County,39125,2068,6359,8842,0.233883736711151,0.719181180728342,4291,-0.485297444017191,39125,8912,3435,5248,125,39,0.385435368043088,0.588868940754039,1813,-0.203433572710952
OH,Perry County,39127,4072,9978,14647,0.278009148631119,0.681231651532737,5906,-0.403222502901618,39127,14673,6857,7498,127,39,0.467320929598583,0.511006610781708,641,-0.043685681183126
OH,Pickaway County,39129,6325,16482,23814,0.265600067187369,0.692113882590073,10157,-0.426513815402704,39129,23443,9335,13713,129,39,0.398199889092693,0.58495073156166,4378,-0.186750842468967
OH,Pike County,39131,3443,7669,11513,0.299053244158777,0.666116563884305,4226,-0.367063319725528,39131,11233,5490,5535,131,39,0.488738538235556,0.492744591827651,45,-0.004006053592095
OH,Portage County,39133,31463,38978,73968,0.425359614968635,0.526957603287908,7515,-0.101597988319273,39133,74029,38082,34465,133,39,0.51442002458496,0.465560793742993,3617,0.048859230841967
OH,Preble County,39135,4323,15376,20475,0.211135531135531,0.750964590964591,11053,-0.53982905982906,39135,19619,6005,13202,135,39,0.306080840002039,0.672919109026964,7197,-0.366838269024925
OH,Putnam County,39137,2874,14704,18387,0.156306085821504,0.799695436993528,11830,-0.643389351172024,39137,18126,4238,13563,137,39,0.233807789915039,0.748262164846077,9325,-0.514454374931038
OH,Richland County,39139,15629,35805,53739,0.290831612050838,0.666275889019148,20176,-0.37544427696831,39139,55954,21785,33057,139,39,0.389337670229117,0.59078886227973,11272,-0.201451192050613
OH,Ross County,39141,9905,17833,28955,0.342082541875324,0.615886720773614,7928,-0.27380417889829,39141,28961,13895,14582,141,39,0.479783156658955,0.50350471323504,687,-0.023721556576085
OH,Sandusky County,39143,9733,16045,27491,0.354043141391728,0.583645556727656,6312,-0.229602415335928,39143,28192,14035,13491,143,39,0.497836265607265,0.478540011350738,544,0.019296254256527
OH,Scioto County,39145,8841,19742,29618,0.298500911607806,0.666554122493078,10901,-0.368053210885272,39145,30023,14432,15023,145,39,0.480698131432568,0.500383039669587,591,-0.019684908237018
OH,Seneca County,39147,7237,14559,23481,0.308206635151825,0.620033218346748,7322,-0.311826583194923,39147,24633,10962,13025,147,39,0.445012787723785,0.528762229529493,2063,-0.083749441805708
OH,Shelby County,39149,4143,18148,23110,0.179273041973172,0.785287754218953,14005,-0.606014712245781,39149,23129,6065,16700,149,39,0.262224912447577,0.722037269229106,10635,-0.45981235678153
OH,Stark County,39151,66581,96345,170868,0.389663365873072,0.563856310134139,29764,-0.174192944261067,39151,176620,86314,86958,151,39,0.488698901596648,0.492345147774884,644,-0.003646246178236
OH,Summit County,39153,129922,109531,249937,0.519818994386585,0.43823443507764,20391,0.081584559308946,39153,259389,147146,108700,153,39,0.567279260107406,0.419061718114492,38446,0.148217541992914
OH,Trumbull County,39155,42130,48152,94073,0.44784369585322,0.511857812549828,6022,-0.064014116696608,39155,98703,59446,37545,155,39,0.602271460847188,0.380383574967326,21901,0.221887885879862
OH,Tuscarawas County,39157,11895,26105,40088,0.296722211135502,0.651192376771103,14210,-0.354470165635602,39157,39855,17516,21420,157,39,0.439493162714841,0.537448249905909,3904,-0.097955087191068
OH,Union County,39159,7530,17601,26533,0.283797535144914,0.663362605057853,10071,-0.379565069912939,39159,24947,8546,15947,159,39,0.342566240429711,0.639235178578587,7401,-0.296668938148876
OH,Van Wert County,39161,2667,10328,13584,0.196333922261484,0.760306242638398,7661,-0.563972320376914,39161,13586,3923,9433,161,39,0.288753128220227,0.69431767996467,5510,-0.405564551744443
OH,Vinton County,39163,1332,3799,5393,0.246986834785833,0.70443167068422,2467,-0.457444835898387,39163,5352,2382,2798,163,39,0.445067264573991,0.522795216741405,416,-0.077727952167414
OH,Warren County,39165,33036,75947,114254,0.28914523780349,0.664720709997024,42911,-0.375575472193534,39165,108008,31907,74626,165,39,0.295413302718317,0.690930301459151,42719,-0.395516998740834
OH,Washington County,39167,7841,19901,28992,0.270453918322296,0.686430739514349,12060,-0.415976821192053,39167,28798,11333,16921,167,39,0.393534273213418,0.5875755260782,5588,-0.194041252864782
OH,Wayne County,39169,14670,31622,48550,0.30216271884655,0.651328527291452,16952,-0.349165808444902,39169,49356,18932,29450,169,39,0.383580517059729,0.596685306750952,10518,-0.213104789691223
OH,Williams County,39171,4287,11706,16938,0.253099539496989,0.691108749557209,7419,-0.43800921006022,39171,17286,7045,9863,171,39,0.40755524702071,0.570577345828995,2818,-0.163022098808284
OH,Wood County,39173,26440,31734,62287,0.424486650504921,0.509480308892706,5294,-0.084993658387786,39173,61967,31596,28997,173,39,0.50988429325286,0.467942614617458,2599,0.041941678635403
OH,Wyandot County,39175,2484,7346,10396,0.238938053097345,0.706617929973067,4862,-0.467679876875722,39175,10254,3962,6054,175,39,0.386385800663156,0.590403744880047,2092,-0.204017944216891
OK,Adair County,40001,1374,4753,6468,0.212430426716141,0.734848484848485,3379,-0.522418058132344,40001,6472,2110,4362,1,40,0.32601977750309,0.67398022249691,2252,-0.34796044499382
OK,Alfalfa County,40003,216,1931,2256,0.095744680851064,0.855939716312057,1715,-0.760195035460993,40003,1817,278,1539,3,40,0.152999449642267,0.847000550357732,1261,-0.694001100715465
OK,Atoka County,40005,795,4068,5002,0.158936425429828,0.81327469012395,3273,-0.654338264694122,40005,4775,1241,3534,5,40,0.259895287958115,0.740104712041885,2293,-0.48020942408377
OK,Beaver County,40007,176,1987,2237,0.078676799284756,0.888243182834153,1811,-0.809566383549397,40007,2300,243,2057,7,40,0.105652173913044,0.894347826086957,1814,-0.788695652173913
OK,Beckham County,40009,958,6287,7529,0.127241333510426,0.83503785363262,5329,-0.707796520122194,40009,6909,1413,5496,9,40,0.204515848892749,0.795484151107251,4083,-0.590968302214503
OK,Blaine County,40011,711,2884,3793,0.187450566833641,0.760348009491168,2173,-0.572897442657527,40011,3815,991,2824,11,40,0.259764089121887,0.740235910878113,1833,-0.480471821756225
OK,Bryan County,40013,2793,10449,13775,0.202758620689655,0.758548094373866,7656,-0.555789473684211,40013,12721,3533,9188,13,40,0.277729738228127,0.722270261771873,5655,-0.444540523543747
OK,Caddo County,40015,2418,6473,9336,0.258997429305913,0.693337617823479,4055,-0.434340188517566,40015,8811,3151,5660,15,40,0.357621155373964,0.642378844626036,2509,-0.284757689252071
OK,Canadian County,40017,11666,39969,55250,0.211149321266968,0.723420814479638,28303,-0.51227149321267,40017,46148,10533,35615,17,40,0.22824391089538,0.77175608910462,25082,-0.54351217820924
OK,Carter County,40019,4002,13751,18533,0.215939135595964,0.741973776506772,9749,-0.526034640910808,40019,17120,4907,12213,19,40,0.286623831775701,0.713376168224299,7306,-0.426752336448598
OK,Cherokee County,40021,5455,9992,16487,0.330866743494875,0.606053254078971,4537,-0.275186510584096,40021,14288,6137,8151,21,40,0.429521276595745,0.570478723404255,2014,-0.140957446808511
OK,Choctaw County,40023,1064,4202,5419,0.196346189333825,0.775419819154826,3138,-0.579073629821,40023,5066,1494,3572,23,40,0.29490722463482,0.70509277536518,2078,-0.410185550730359
OK,Cimarron County,40025,70,962,1077,0.064995357474466,0.89322191272052,892,-0.828226555246054,40025,1197,115,1082,25,40,0.096073517126149,0.903926482873851,967,-0.807852965747702
OK,Cleveland County,40027,38790,62469,109326,0.354810383623292,0.571401130563635,23679,-0.216590746940344,40027,93720,34701,59019,27,40,0.370262483994878,0.629737516005122,24318,-0.259475032010243
OK,Coal County,40029,411,1892,2393,0.171750940242374,0.790639364814041,1481,-0.618888424571667,40029,2357,648,1709,29,40,0.274925753075944,0.725074246924056,1061,-0.450148493848112
OK,Comanche County,40031,11439,19153,32504,0.351925916810239,0.589250553777996,7714,-0.237324636967758,40031,30174,12517,17657,31,40,0.414827334791542,0.585172665208458,5140,-0.170345330416915
OK,Cotton County,40033,424,2054,2602,0.162951575710992,0.789392774788624,1630,-0.626441199077633,40033,2453,657,1796,33,40,0.267835303709743,0.732164696290257,1139,-0.464329392580514
OK,Craig County,40035,1249,4279,5778,0.216164762893735,0.740567670474213,3030,-0.524402907580478,40035,5298,1746,3552,35,40,0.32955832389581,0.67044167610419,1806,-0.34088335220838
OK,Creek County,40037,5834,21539,28786,0.202667963593413,0.748245674980893,15705,-0.54557771138748,40037,26078,7114,18964,37,40,0.272796993634481,0.727203006365519,11850,-0.454406012731038
OK,Custer County,40039,2102,7818,10531,0.199601177476023,0.742379641059728,5716,-0.542778463583705,40039,9800,2358,7442,39,40,0.240612244897959,0.759387755102041,5084,-0.518775510204082
OK,Delaware County,40041,3306,11796,15680,0.210841836734694,0.752295918367347,8490,-0.541454081632653,40041,14232,4176,10056,41,40,0.293423271500843,0.706576728499157,5880,-0.413153456998314
OK,Dewey County,40043,222,1964,2246,0.098842386464826,0.874443455031167,1742,-0.77560106856634,40043,2070,301,1769,43,40,0.145410628019324,0.854589371980676,1468,-0.709178743961353
OK,Ellis County,40045,155,1610,1826,0.084884994523549,0.88170865279299,1455,-0.796823658269441,40045,1801,226,1575,45,40,0.125485841199334,0.874514158800666,1349,-0.749028317601333
OK,Garfield County,40047,4391,15998,21692,0.202424857090171,0.737506914991702,11607,-0.535082057901531,40047,19908,4732,15176,47,40,0.237693389592124,0.762306610407876,10444,-0.524613220815753
OK,Garvin County,40049,1852,8243,10531,0.175861741525021,0.782736682176431,6391,-0.60687494065141,40049,9478,2556,6922,49,40,0.269677147077442,0.730322852922557,4366,-0.460645705845115
OK,Grady County,40051,3878,17293,22257,0.174237318596397,0.776969043447005,13415,-0.602731724850609,40051,19598,4780,14818,51,40,0.24390243902439,0.75609756097561,10038,-0.51219512195122
OK,Grant County,40053,287,1827,2200,0.130454545454545,0.830454545454545,1540,-0.7,40053,2067,393,1674,53,40,0.190130624092888,0.809869375907112,1281,-0.619738751814223
OK,Greer County,40055,323,1482,1896,0.17035864978903,0.781645569620253,1159,-0.611286919831224,40055,1832,488,1344,55,40,0.266375545851528,0.733624454148472,856,-0.467248908296943
OK,Harmon County,40057,224,714,975,0.22974358974359,0.732307692307692,490,-0.502564102564103,40057,923,264,659,57,40,0.28602383531961,0.71397616468039,395,-0.42795232936078
OK,Harper County,40059,131,1307,1485,0.088215488215488,0.88013468013468,1176,-0.791919191919192,40059,1434,173,1261,59,40,0.120641562064156,0.879358437935844,1088,-0.758716875871688
OK,Haskell County,40061,882,3697,4734,0.186311787072243,0.780946345585129,2815,-0.594634558512886,40061,4244,1175,3069,61,40,0.276861451460886,0.723138548539114,1894,-0.446277097078228
OK,Hughes County,40063,961,3387,4525,0.212375690607735,0.748508287292818,2426,-0.536132596685083,40063,4206,1370,2836,63,40,0.325725154541132,0.674274845458868,1466,-0.348549690917737
OK,Jackson County,40065,1473,5969,7806,0.18870099923136,0.764668203945683,4496,-0.575967204714322,40065,7915,1953,5962,65,40,0.246746683512318,0.753253316487682,4009,-0.506506632975363
OK,Jefferson County,40067,365,1905,2345,0.155650319829424,0.812366737739872,1540,-0.656716417910448,40067,2234,602,1632,67,40,0.269471799462847,0.730528200537153,1030,-0.461056401074306
OK,Johnston County,40069,782,3081,4001,0.195451137215696,0.770057485628593,2299,-0.574606348412897,40069,3778,1134,2644,69,40,0.300158814187401,0.699841185812599,1510,-0.399682371625198
OK,Kay County,40071,3734,12168,16795,0.222328073831497,0.72450133968443,8434,-0.502173265852932,40071,16122,4624,11498,71,40,0.286813050490014,0.713186949509986,6874,-0.426373899019973
OK,Kingfisher County,40073,783,5151,6123,0.127878490935816,0.84125428711416,4368,-0.713375796178344,40073,5354,844,4510,73,40,0.157639148300336,0.842360851699664,3666,-0.684721703399328
OK,Kiowa County,40075,766,2593,3489,0.219547148179994,0.743192891946116,1827,-0.523645743766122,40075,3410,1101,2309,75,40,0.322873900293255,0.677126099706745,1208,-0.35425219941349
OK,Latimer County,40077,797,3094,4050,0.19679012345679,0.763950617283951,2297,-0.567160493827161,40077,3789,1169,2620,77,40,0.308524676695698,0.691475323304302,1451,-0.382950646608604
OK,Le Flore County,40079,3245,13346,17199,0.188673760102332,0.775975347403919,10101,-0.587301587301587,40079,15830,4658,11172,79,40,0.294251421351864,0.705748578648136,6514,-0.411497157296273
OK,Lincoln County,40081,2423,10838,14001,0.173059067209485,0.774087565173916,8415,-0.601028497964431,40081,12807,3265,9542,81,40,0.254938705395487,0.745061294604513,6277,-0.490122589209026
OK,Logan County,40083,4239,13613,18948,0.223717542748575,0.718439940890859,9374,-0.494722398142284,40083,16983,4686,12297,83,40,0.275922981805335,0.724077018194665,7611,-0.448154036389331
OK,Love County,40085,735,2920,3787,0.194085027726432,0.771058885661474,2185,-0.576973857935041,40085,3470,1034,2436,85,40,0.297982708933718,0.702017291066282,1402,-0.404034582132565
OK,McClain County,40087,2893,13151,16839,0.171803551279767,0.780984619039135,10258,-0.609181067759368,40087,14299,3191,11108,87,40,0.223162458913211,0.776837541086789,7917,-0.553675082173579
OK,McCurtain County,40089,1799,8642,10709,0.167989541507143,0.806984779157718,6843,-0.638995237650574,40089,10073,2440,7633,89,40,0.242231708527747,0.757768291472253,5193,-0.515536582944505
OK,McIntosh County,40091,2122,5501,7958,0.266649912038201,0.691254083940689,3379,-0.424604171902488,40091,7265,2767,4498,91,40,0.38086717136958,0.61913282863042,1731,-0.23826565726084
OK,Major County,40093,310,2940,3399,0.09120329508679,0.864960282436011,2630,-0.77375698734922,40093,3146,446,2700,93,40,0.141767323585505,0.858232676414495,2254,-0.716465352828989
OK,Marshall County,40095,1095,4202,5487,0.199562602515036,0.765810096591944,3107,-0.566247494076909,40095,5140,1396,3744,95,40,0.2715953307393,0.7284046692607,2348,-0.456809338521401
OK,Mayes County,40097,3423,11550,15712,0.217858961303462,0.735106924643585,8127,-0.517247963340122,40097,14456,4822,9634,97,40,0.333563918096292,0.666436081903708,4812,-0.332872163807416
OK,Murray County,40099,1086,4173,5525,0.196561085972851,0.755294117647059,3087,-0.558733031674208,40099,5146,1540,3606,99,40,0.299261562378546,0.700738437621454,2066,-0.401476875242907
OK,Muskogee County,40101,7969,15029,24193,0.329392799570124,0.621212747488943,7060,-0.291819947918819,40101,23335,9943,13392,101,40,0.426098135847439,0.573901864152561,3449,-0.147803728305121
OK,Noble County,40103,901,3707,4870,0.185010266940452,0.761190965092403,2806,-0.576180698151951,40103,4626,1142,3484,103,40,0.246865542585387,0.753134457414613,2342,-0.506268914829226
OK,Nowata County,40105,742,3321,4237,0.175123908425773,0.783809299032334,2579,-0.608685390606561,40105,4076,1244,2832,105,40,0.305201177625123,0.694798822374877,1588,-0.389597644749755
OK,Okfuskee County,40107,943,2791,3933,0.239766081871345,0.709636409865243,1848,-0.469870327993898,40107,3579,1251,2328,107,40,0.34953897736798,0.65046102263202,1077,-0.30092204526404
OK,Oklahoma County,40109,112661,141429,273609,0.411759116110947,0.516901856298587,28768,-0.10514274018764,40109,256337,106812,149525,109,40,0.41668584714653,0.58331415285347,42713,-0.16662830570694
OK,Okmulgee County,40111,4379,8926,13924,0.314492961792588,0.641051422005171,4547,-0.326558460212583,40111,13128,5416,7712,111,40,0.412553321145643,0.587446678854357,2296,-0.174893357708714
OK,Osage County,40113,5593,12559,18942,0.295269770879527,0.663023967902017,6966,-0.36775419702249,40113,17913,6695,11218,113,40,0.373750907162396,0.626249092837604,4523,-0.252498185675208
OK,Ottawa County,40115,2584,7627,10686,0.241811716264271,0.713737600598914,5043,-0.471925884334643,40115,9973,3508,6465,115,40,0.35174972425549,0.64825027574451,2957,-0.29650055148902
OK,Pawnee County,40117,1341,4716,6346,0.211314213677907,0.743145288370627,3375,-0.53183107469272,40117,6041,1813,4228,117,40,0.300115874855156,0.699884125144843,2415,-0.399768250289687
OK,Payne County,40119,8785,16644,27749,0.316587985152618,0.599805398392735,7859,-0.283217413240117,40119,25660,9193,16467,119,40,0.358261886204209,0.641738113795791,7274,-0.283476227591582
OK,Pittsburg County,40121,3704,12740,17250,0.214724637681159,0.738550724637681,9036,-0.523826086956522,40121,15598,4813,10785,121,40,0.308565200666752,0.691434799333248,5972,-0.382869598666496
OK,Pontotoc County,40123,3633,10420,14814,0.245240988254354,0.703388686377751,6787,-0.458147698123397,40123,12855,3934,8921,123,40,0.306028782574874,0.693971217425126,4987,-0.387942434850253
OK,Pottawatomie County,40125,6005,17826,25417,0.2362591966007,0.701341621749223,11821,-0.465082425148523,40125,23422,7182,16240,125,40,0.306634787806336,0.693365212193664,9058,-0.386730424387328
OK,Pushmataha County,40127,748,3581,4483,0.166852554093241,0.798795449475797,2833,-0.631942895382556,40127,4130,1043,3087,127,40,0.252542372881356,0.747457627118644,2044,-0.494915254237288
OK,Roger Mills County,40129,151,1546,1758,0.085893060295791,0.879408418657565,1395,-0.793515358361775,40129,1674,272,1402,129,40,0.162485065710872,0.837514934289128,1130,-0.675029868578256
OK,Rogers County,40131,7895,30893,40834,0.193343782142332,0.756550913454474,22998,-0.563207131312142,40131,36677,9146,27531,131,40,0.24936608773891,0.75063391226109,18385,-0.50126782452218
OK,Seminole County,40133,2067,5612,8032,0.25734561752988,0.698705179282869,3545,-0.441359561752988,40133,7449,2597,4852,133,40,0.348637400993422,0.651362599006578,2255,-0.302725198013156
OK,Sequoyah County,40135,3061,10888,14437,0.212024658862645,0.754173304703193,7827,-0.542148645840549,40135,13766,4193,9573,135,40,0.304591021356966,0.695408978643034,5380,-0.390817957286067
OK,Stephens County,40137,3084,14166,17886,0.172425360617243,0.792016101979202,11082,-0.619590741361959,40137,16846,3939,12907,137,40,0.2338240531877,0.7661759468123,8968,-0.532351893624599
OK,Texas County,40139,855,4615,5771,0.148154565933114,0.799688095650667,3760,-0.651533529717553,40139,5762,854,4908,139,40,0.148212426240889,0.851787573759111,4054,-0.703575147518223
OK,Tillman County,40141,657,1944,2706,0.242793791574279,0.71840354767184,1287,-0.475609756097561,40141,2719,906,1813,141,40,0.333210739242368,0.666789260757631,907,-0.333578521515263
OK,Tulsa County,40143,87663,143985,246557,0.355548615533122,0.583982608484042,56322,-0.22843399295092,40143,227541,82633,144908,143,40,0.36315653003195,0.63684346996805,62275,-0.273686939936099
OK,Wagoner County,40145,6711,22967,31246,0.214779491774947,0.735038084874864,16256,-0.520258593099917,40145,28621,7773,20848,145,40,0.271583802103351,0.728416197896649,13075,-0.456832395793299
OK,Washington County,40147,5047,15810,22208,0.227260446685879,0.711905619596542,10763,-0.484645172910663,40147,21199,5532,15667,147,40,0.260955705457805,0.739044294542195,10135,-0.478088589084391
OK,Washita County,40149,588,3851,4628,0.127052722558341,0.832108902333621,3263,-0.705056179775281,40149,4303,821,3482,149,40,0.190797118289565,0.809202881710434,2661,-0.618405763420869
OK,Woods County,40151,521,2945,3665,0.142155525238745,0.803547066848568,2424,-0.661391541609823,40151,3395,670,2725,151,40,0.197349042709867,0.802650957290133,2055,-0.605301914580265
OK,Woodward County,40153,871,6329,7573,0.115013865046877,0.835732206523174,5458,-0.720718341476297,40153,7065,1129,5936,153,40,0.159801840056617,0.840198159943383,4807,-0.680396319886766
OR,Baker County,41001,1781,6160,8479,0.210048354758816,0.726500766599835,4379,-0.516452411841019,41001,8351,2364,5692,1,41,0.283079870674171,0.681595018560651,3328,-0.398515147886481
OR,Benton County,41003,28431,13030,45577,0.623801478816069,0.285889812844198,15401,0.337911665971872,41003,44262,27662,14922,3,41,0.624960462699381,0.337128914192761,12740,0.28783154850662
OR,Clackamas County,41005,90187,79062,182136,0.49516295515439,0.434082224271973,11125,0.061080730882418,41005,185564,94013,87551,5,41,0.506633829837684,0.471810264922075,6462,0.034823564915609
OR,Clatsop County,41007,8899,7794,18158,0.490087013988325,0.42923229430554,1105,0.060854719682785,41007,17206,9616,7101,7,41,0.558874811112403,0.412704870394049,2515,0.146169940718354
OR,Columbia County,41009,9959,12967,25077,0.397136818598716,0.517087370897635,3008,-0.119950552298919,41009,23298,11843,10645,9,41,0.508326895012447,0.456906172203623,1198,0.051420722808825
OR,Coos County,41011,10355,17699,30181,0.343096650210397,0.586428547761837,7344,-0.24333189755144,41011,27926,12628,14398,11,41,0.452195087015684,0.515576881758934,1770,-0.06338179474325
OR,Crook County,41013,2591,8388,11638,0.222632754768861,0.720742395600619,5797,-0.498109640831758,41013,10109,3081,6769,13,41,0.304777920664754,0.669601345335839,3688,-0.364823424671085
OR,Curry County,41015,4253,7157,12163,0.34966702293842,0.588423908575187,2904,-0.238756885636767,41015,11529,4611,6577,15,41,0.399947957325006,0.570474455720357,1966,-0.170526498395351
OR,Deschutes County,41017,40222,43667,90584,0.444029850746269,0.482060849598163,3445,-0.038030998851894,41017,77441,34985,40670,17,41,0.451763277850234,0.525174003434873,5685,-0.073410725584639
OR,Douglas County,41019,13891,34112,51350,0.270516066212269,0.664303797468354,20221,-0.393787731256086,41019,49062,17032,30588,19,41,0.3471525824467,0.623456035220741,13556,-0.276303452774041
OR,Gilliam County,41021,221,632,937,0.235859124866596,0.674493062966916,411,-0.43863393810032,41021,1044,371,637,21,41,0.355363984674329,0.610153256704981,266,-0.254789272030651
OR,Grant County,41023,732,3187,4171,0.175497482618077,0.764085351234716,2455,-0.588587868616639,41023,3778,834,2848,23,41,0.22075172048703,0.753838009528851,2014,-0.533086289041821
OR,Harney County,41025,682,2904,3850,0.177142857142857,0.754285714285714,2222,-0.577142857142857,41025,3535,829,2599,25,41,0.234512022630834,0.735219236209335,1770,-0.500707213578501
OR,Hood River County,41027,6359,3223,10383,0.612443417124145,0.310411249157276,3136,0.302032167966869,41027,9662,5977,3400,27,41,0.618608983647278,0.351894017801697,2577,0.266714965845581
OR,Jackson County,41029,43550,53083,103789,0.419601306496835,0.511451117170413,9533,-0.091849810673578,41029,91955,42341,46974,29,41,0.460453482681747,0.510836822358762,4633,-0.050383339677016
OR,Jefferson County,41031,2892,5337,8874,0.325895875591616,0.601419878296146,2445,-0.27552400270453,41031,7978,3238,4576,31,41,0.405866131862622,0.573577337678616,1338,-0.167711205815994
OR,Josephine County,41033,13223,26582,42613,0.310304367211884,0.623800248750381,13359,-0.313495881538498,41033,39679,14929,23636,33,41,0.376244360997001,0.595680334685854,8707,-0.219435973688853
OR,Klamath County,41035,7080,20170,29240,0.242134062927497,0.689808481532148,13090,-0.447674418604651,41035,27530,8140,18654,35,41,0.295677442789684,0.677588085724664,10514,-0.38191064293498
OR,Lake County,41037,628,3001,3814,0.16465652857892,0.786837965390666,2373,-0.622181436811746,41037,3676,769,2801,37,41,0.209194776931447,0.761969532100109,2032,-0.552774755168661
OR,Lane County,41039,100497,66218,181072,0.555011266236635,0.365699832110983,34279,0.189311434125652,41039,166176,99891,60979,39,41,0.60111568457539,0.366954313498941,38912,0.234161371076449
OR,Lincoln County,41041,12300,9901,24035,0.511753692531725,0.411940919492407,2399,0.099812773039318,41041,22612,13277,8623,41,41,0.587166106492128,0.38134618786485,4654,0.205819918627278
OR,Linn County,41043,17456,32683,54724,0.318982530516775,0.597233389372122,15227,-0.278250858855347,41043,49987,19893,28482,43,41,0.397963470502331,0.569788144917679,8589,-0.171824674415348
OR,Malheur County,41045,2213,7141,9950,0.222412060301508,0.717688442211055,4928,-0.495276381909548,41045,9711,2701,6751,45,41,0.278138193800844,0.695191020492225,4050,-0.417052826691381
OR,Marion County,41047,48803,54336,110804,0.440444388289231,0.490379408685607,5533,-0.049935020396376,41047,115519,54337,58435,47,41,0.470372839100062,0.505847522918308,4098,-0.035474683818246
OR,Morrow County,41049,1004,2698,3989,0.25169215342191,0.676359989972424,1694,-0.424667836550514,41049,3838,1189,2524,49,41,0.309796769150599,0.657634184471079,1335,-0.347837415320479
OR,Multnomah County,41051,271754,63055,357762,0.759594367205013,0.176248455677238,208699,0.583345911527776,41051,344614,261222,71947,51,41,0.758013313446349,0.208775615616313,189275,0.549237697830036
OR,Polk County,41053,15741,18333,37030,0.425087766675668,0.495085066162571,2592,-0.069997299486903,41053,33996,15761,17377,53,41,0.463613366278386,0.511148370396517,1616,-0.047535004118132
OR,Sherman County,41055,202,726,983,0.205493387589013,0.738555442522889,524,-0.533062054933876,41055,1019,317,677,55,41,0.311089303238469,0.664376840039254,360,-0.353287536800785
OR,Tillamook County,41057,5701,6486,13261,0.429907246813966,0.489103385868336,785,-0.05919613905437,41057,12346,6249,5670,57,41,0.506155839948161,0.459258059290458,579,0.046897780657703
OR,Umatilla County,41059,7466,16775,26116,0.285878388727217,0.642326543115331,9309,-0.356448154388114,41059,24623,8499,15425,59,41,0.34516508955042,0.626446818015676,6926,-0.281281728465256
OR,Union County,41061,3221,8378,12465,0.258403529883674,0.672121941436021,5157,-0.413718411552347,41061,11905,3943,7608,61,41,0.331205375892482,0.639059218815624,3665,-0.307853842923141
OR,Wallowa County,41063,1097,2825,4177,0.262628680871439,0.676322719655255,1728,-0.413694038783816,41063,4152,1252,2796,63,41,0.301541425818882,0.673410404624277,1544,-0.371868978805395
OR,Wasco County,41065,4634,5721,11251,0.41187450004444,0.508488134388054,1087,-0.096613634343614,41065,10550,5066,5152,65,41,0.480189573459716,0.488341232227488,86,-0.008151658767773
OR,Washington County,41067,137818,75903,232034,0.59395605816389,0.327120163424326,61915,0.266835894739564,41067,216473,124431,86551,67,41,0.574810715424094,0.399823534574751,37880,0.174987180849344
OR,Wheeler County,41069,153,583,792,0.193181818181818,0.736111111111111,430,-0.542929292929293,41069,841,262,542,69,41,0.3115338882283,0.644470868014269,280,-0.332936979785969
OR,Yamhill County,41071,18635,22589,45116,0.413046369358986,0.500687117652274,3954,-0.087640748293289,41071,41750,18906,21711,71,41,0.452838323353294,0.520023952095808,2805,-0.067185628742515
PA,Adams County,42001,14077,31249,47138,0.298633798633799,0.662925877211591,17172,-0.364292078577793,42001,41973,14893,26490,1,42,0.354823338813046,0.631120005717962,11597,-0.276296666904915
PA,Allegheny County,42003,363017,257488,643173,0.564415794817258,0.40034018840965,105529,0.164075606407607,42003,614671,348151,259304,3,42,0.56640218913858,0.421858197312058,88847,0.144543991826522
PA,Armstrong County,42005,6849,22676,30446,0.224955659199895,0.74479406161729,15827,-0.519838402417395,42005,28322,8694,19231,5,42,0.306969846762234,0.679012781583222,10537,-0.372042934820987
PA,Beaver County,42007,30225,46081,79036,0.382420669062199,0.583038109216053,15856,-0.200617440153854,42007,80015,36833,42118,7,42,0.460326188839593,0.526376304442917,5285,-0.066050115603324
PA,Bedford County,42009,3613,19455,23504,0.153718515997277,0.827731449965963,15842,-0.674012933968686,42009,21444,4730,16509,9,42,0.220574519679164,0.769865696698377,11779,-0.549291177019213
PA,Berks County,42011,75169,93094,175934,0.427256812213671,0.529141609921903,17925,-0.101884797708231,42011,163253,79895,80857,11,42,0.48939376305489,0.495286457216713,962,-0.005892694161822
PA,Blair County,42013,13093,37224,52029,0.251648119318073,0.715447154471545,24131,-0.463799035153472,42013,47631,15516,31500,13,42,0.325754235686843,0.661334005164704,15984,-0.335579769477861
PA,Bradford County,42015,6263,17957,25399,0.246584511201228,0.706996338438521,11694,-0.460411827237293,42015,22501,8291,13827,15,42,0.368472512332785,0.61450602195458,5536,-0.246033509621795
PA,Bucks County,42017,165861,163873,342572,0.484163912987635,0.478360753359878,1988,0.005803159627757,42017,319407,159598,155876,17,42,0.499669700413579,0.488016856236714,3722,0.011652844176865
PA,Butler County,42019,26834,61388,92027,0.291588338205092,0.667065100459648,34554,-0.375476762254556,42019,88924,28385,59416,19,42,0.319205163960236,0.668166074400612,31031,-0.348960910440376
PA,Cambria County,42021,17798,40510,60167,0.29580999551249,0.673292668738677,22712,-0.377482673226187,42021,57718,23181,33464,21,42,0.401625142936346,0.579784469316331,10283,-0.178159326379985
PA,Cameron County,42023,469,1495,2024,0.231719367588933,0.738636363636364,1026,-0.506916996047431,42023,1967,677,1264,23,42,0.344178952719878,0.642602948652771,587,-0.298423995932893
PA,Carbon County,42025,8917,18714,28721,0.310469691166742,0.651578984018662,9797,-0.34110929285192,42025,24232,11040,12710,25,42,0.455595906239683,0.524513040607461,1670,-0.068917134367778
PA,Centre County,42027,36555,35099,75394,0.484852906066796,0.465541024484707,1456,0.019311881582089,42027,68801,33677,33697,27,42,0.489484164474354,0.489774857923577,20,-0.000290693449223
PA,Chester County,42029,140188,115582,266637,0.525763491188395,0.433480724730626,24606,0.092282766457769,42029,248295,122232,123280,29,42,0.492285386334803,0.496506172093679,1048,-0.004220785758876
PA,Clarion County,42031,4256,12545,17481,0.243464332704079,0.717636290830044,8289,-0.474171958125965,42031,15227,4731,10228,31,42,0.310698102055559,0.671701582714914,5497,-0.361003480659355
PA,Clearfield County,42033,7700,23909,32692,0.235531628532974,0.731341000856479,16209,-0.495809372323504,42033,31894,11093,20303,33,42,0.347808365209757,0.636577412679501,9210,-0.288769047469743
PA,Clinton County,42035,4533,9701,14839,0.305478805849451,0.653750252712447,5168,-0.348271446862996,42035,12663,5503,6941,35,42,0.43457316591645,0.548132354102503,1438,-0.113559188186054
PA,Columbia County,42037,8502,17387,27127,0.313414679102002,0.640948132856564,8885,-0.327533453754562,42037,24305,10424,13445,37,42,0.428882945895906,0.553178358362477,3021,-0.124295412466571
PA,Crawford County,42039,10215,23912,35563,0.287236734808649,0.672384219554031,13697,-0.385147484745381,42039,33089,13024,19497,39,42,0.393605125570431,0.589229048928647,6473,-0.195623923358216
PA,Cumberland County,42041,44282,65649,115068,0.384833315952307,0.570523516529356,21367,-0.18569020057705,42041,109964,43983,64365,41,42,0.399976355898294,0.585327925502892,20382,-0.185351569604598
PA,Dauphin County,42043,64287,60620,130160,0.49390749846343,0.465734480639213,3667,0.028173017824216,42043,122625,64209,56838,43,42,0.523620795107034,0.463510703363914,7371,0.060110091743119
PA,Delaware County,42045,169169,106559,284832,0.593925542073924,0.374111757105943,62610,0.219813784967981,42045,272853,164805,105270,45,42,0.604006552979077,0.385812140603182,59535,0.218194412375895
PA,Elk County,42047,3637,9704,13854,0.262523458928829,0.700447524180742,6067,-0.437924065251913,42047,12425,5144,7099,47,42,0.414004024144869,0.571348088531187,1955,-0.157344064386318
PA,Erie County,42049,54820,57168,117240,0.467587853974753,0.487615148413511,2348,-0.020027294438758,42049,112732,65136,46102,49,42,0.577795124720576,0.408952205230103,19034,0.168842919490473
PA,Fayette County,42051,17826,34388,53426,0.333657769625276,0.643656646576573,16562,-0.309998876951297,42051,48196,21841,25845,51,42,0.453170387584032,0.536247821395966,4004,-0.083077433811935
PA,Forest County,42053,626,1680,2398,0.261050875729775,0.700583819849875,1054,-0.4395329441201,42053,2308,894,1381,53,42,0.38734835355286,0.598353552859619,487,-0.211005199306759
PA,Franklin County,42055,17322,49554,69345,0.249794505732208,0.714600908500973,32232,-0.464806402768765,42055,62802,18910,43072,55,42,0.301105060348397,0.685838030635967,24162,-0.38473297028757
PA,Fulton County,42057,904,5676,6743,0.134064956250927,0.841761827079935,4772,-0.707696870829008,42057,6148,1297,4780,57,42,0.210962914769031,0.777488614183474,3483,-0.566525699414444
PA,Greene County,42059,4157,10394,14955,0.277967235038449,0.69501838849883,6237,-0.417051153460381,42059,13726,5564,7985,59,42,0.405362086551071,0.581742678129098,2421,-0.176380591578027
PA,Huntingdon County,42061,4487,14369,19496,0.23014977431268,0.73702297907263,9882,-0.506873204759951,42061,17587,5383,11953,61,42,0.306078353329164,0.679649741286177,6570,-0.373571387957014
PA,Indiana County,42063,11468,24920,37728,0.303965224766751,0.660517387616624,13452,-0.356552162849873,42063,36180,14403,21187,63,42,0.398092868988391,0.585599778883361,6784,-0.18750690989497
PA,Jefferson County,42065,3437,14533,18551,0.185273031103445,0.783407902538947,11096,-0.598134871435502,42065,17072,4535,12288,65,42,0.265639643861293,0.719775070290534,7753,-0.454135426429241
PA,Juniata County,42067,1810,8234,10402,0.174004999038646,0.791578542587964,6424,-0.617573543549317,42067,9480,2533,6821,67,42,0.267194092827004,0.719514767932489,4288,-0.452320675105485
PA,Lackawanna County,42069,51593,48102,102740,0.50217052754526,0.468191551489196,3491,0.033978976056064,42069,97116,61309,34730,69,42,0.631296593764158,0.357613575517937,26579,0.273683018246221
PA,Lancaster County,42071,90066,137145,239151,0.376607248140296,0.573466136457719,47079,-0.196858888317423,42071,219677,87108,129364,71,42,0.396527629201054,0.588882768792363,42256,-0.192355139591309
PA,Lawrence County,42073,13933,25323,40555,0.3435581309333,0.624411293305388,11390,-0.280853162372087,42073,38816,17427,20915,73,42,0.448964344600165,0.538824196207749,3488,-0.089859851607585
PA,Lebanon County,42075,17860,38804,58906,0.303194920721149,0.658744440294707,20944,-0.355549519573558,42075,53771,18975,34010,75,42,0.352885384314965,0.63249707091183,15035,-0.279611686596865
PA,Lehigh County,42077,77087,70285,153031,0.503734537446661,0.459286027014134,6802,0.044448510432527,42077,144922,77029,66091,77,42,0.531520404079436,0.45604532093126,10938,0.075475083148176
PA,Luzerne County,42079,51454,77508,132731,0.387656237050877,0.583947985022338,26054,-0.196291747971461,42079,123741,63974,57969,79,42,0.516999216104606,0.468470434213397,6005,0.048528781891208
PA,Lycoming County,42081,12926,35475,50294,0.257008788324651,0.705352527140414,22549,-0.448343738815763,42081,46214,15104,30490,81,42,0.326827368329943,0.659756783658632,15386,-0.332929415328688
PA,McKean County,42083,3802,11159,15572,0.244156177754945,0.716606730028256,7357,-0.472450552273311,42083,15014,5260,9494,83,42,0.350339682962568,0.632343146396696,4234,-0.282003463434128
PA,Mercer County,42085,17631,30034,49594,0.355506714521918,0.605597451304593,12403,-0.250090736782675,42085,48065,23082,24304,85,42,0.48022469572454,0.505648600853012,1222,-0.025423905128472
PA,Mifflin County,42087,3563,14050,18239,0.195350622292889,0.770327320576786,10487,-0.574976698283897,42087,16311,4259,11893,87,42,0.261112132916437,0.729139844276868,7634,-0.468027711360432
PA,Monroe County,42089,31930,31706,65944,0.484198714060415,0.480801892514861,224,0.003396821545554,42089,59312,33431,25100,89,42,0.563646479633127,0.423185864580523,8331,0.140460615052603
PA,Montgomery County,42091,251063,160803,427489,0.587296983080266,0.376157047315837,90260,0.211139935764429,42091,401787,227561,169903,91,42,0.566372232053302,0.422868335710215,57658,0.143503896343087
PA,Montour County,42093,2851,5274,8535,0.334036321031049,0.61792618629174,2423,-0.283889865260691,42093,7787,3026,4636,93,42,0.388596378579684,0.595351226402979,1610,-0.206754847823295
PA,Northampton County,42095,65936,71384,142775,0.461817545088426,0.499975485904395,5448,-0.038157940815969,42095,125883,65014,59242,95,42,0.516463700420232,0.470611599660002,5772,0.04585210076023
PA,Northumberland County,42097,9184,24418,34971,0.262617597437877,0.698235680992823,15234,-0.435618083554946,42097,31512,12392,18516,97,42,0.393247017009393,0.587585681645088,6124,-0.194338664635694
PA,Perry County,42099,4630,15613,21153,0.218881482532029,0.738098614853685,10983,-0.519217132321657,42099,18240,5430,12511,99,42,0.297697368421053,0.685910087719298,7081,-0.388212719298246
PA,Philadelphia County,42101,560542,105418,680227,0.824051382847197,0.154974736374769,455124,0.669076646472428,42101,653598,557024,91840,101,42,0.852242509922001,0.140514505858341,465184,0.71172800406366
PA,Pike County,42103,9247,16035,26066,0.354753318499194,0.615169185912683,6788,-0.260415867413489,42103,23164,10170,12713,103,42,0.439043343118632,0.548825764116733,2543,-0.109782420998101
PA,Potter County,42105,1300,6247,7777,0.167159573100167,0.803266040889803,4947,-0.636106467789636,42105,7205,1892,5199,105,42,0.262595419847328,0.721582234559334,3307,-0.458986814712006
PA,Schuylkill County,42107,16724,43937,62750,0.266517928286853,0.700191235059761,27213,-0.433673306772908,42107,57505,24453,32156,107,42,0.425232588470568,0.559186157725415,7703,-0.133953569254847
PA,Snyder County,42109,3991,11710,16333,0.244351925549501,0.716953407212392,7719,-0.472601481662891,42109,14962,4672,10050,109,42,0.312257719556209,0.671701644165219,5378,-0.35944392460901
PA,Somerset County,42111,7367,27347,35730,0.20618527847747,0.76537923313742,19980,-0.55919395465995,42111,33875,9420,23935,111,42,0.278081180811808,0.706568265682657,14515,-0.428487084870849
PA,Sullivan County,42113,756,2318,3168,0.238636363636364,0.731691919191919,1562,-0.493055555555556,42113,2934,1028,1859,113,42,0.350374914792093,0.633605998636673,831,-0.283231083844581
PA,Susquehanna County,42115,5065,13295,19200,0.263802083333333,0.692447916666667,8230,-0.428645833333333,42115,17930,6891,10735,115,42,0.384327941996654,0.598717233686559,3844,-0.214389291689905
PA,Tioga County,42117,3642,12928,17334,0.210107303565247,0.745817468558902,9286,-0.535710164993654,42117,15943,5053,10599,117,42,0.31694160446591,0.664805870915135,5546,-0.347864266449225
PA,Union County,42119,6138,10605,17400,0.352758620689655,0.60948275862069,4467,-0.256724137931034,42119,16187,6063,9863,119,42,0.374559831963922,0.609316117872367,3800,-0.234756285908445
PA,Venango County,42121,5889,15254,22096,0.266518826937002,0.690351194786387,9365,-0.423832367849384,42121,20775,7469,12928,121,42,0.359518652226234,0.622286401925391,5459,-0.262767749699158
PA,Warren County,42123,4828,12032,17624,0.273944620971403,0.682705401724921,7204,-0.408760780753518,42123,16462,6768,9415,123,42,0.411128659944114,0.571923217106062,2647,-0.160794557161949
PA,Washington County,42125,34436,58941,96945,0.355211717984424,0.607983908401671,24505,-0.252772190417247,42125,90078,38503,50455,125,42,0.427440662536912,0.560125668864762,11952,-0.132685006327849
PA,Wayne County,42127,6398,15269,22365,0.286071987480438,0.682718533422759,8871,-0.396646545942321,42127,20966,8138,12531,127,42,0.388152246494324,0.597681961270629,4393,-0.209529714776304
PA,Westmoreland County,42129,59506,116427,181740,0.327423792230659,0.640623968306372,56921,-0.313200176075712,42129,168709,63380,103429,129,42,0.37567646065118,0.613061543841763,40049,-0.237385083190583
PA,Wyoming County,42131,3573,8375,12418,0.287727492349815,0.674424222902239,4802,-0.386696730552424,42131,11214,4812,6189,131,42,0.429106474050294,0.551899411449973,1377,-0.122792937399679
PA,York County,42133,67428,126933,203153,0.331907478599873,0.624814794760599,59505,-0.292907316160726,42133,186394,72126,111576,133,42,0.386954515703295,0.598602959322725,39450,-0.21164844361943
RI,Bristol County,44001,14532,8910,24691,0.588554534040744,0.360860232473371,5622,0.227694301567373,44001,24563,14943,9216,1,44,0.608354028416724,0.375198469242356,5727,0.233155559174368
RI,Kent County,44003,37582,38141,79691,0.471596541642093,0.478611135510911,559,-0.007014593868818,44003,77247,44966,30786,3,44,0.582106748482142,0.398539749116471,14180,0.183566999365671
RI,Newport County,44005,22680,14975,39761,0.57040818892885,0.3766253363849,7705,0.19378285254395,44005,40545,23507,16343,5,44,0.579775558021951,0.403082994203971,7164,0.17669256381798
RI,Providence County,44007,141597,90321,241818,0.585551944024018,0.373508175570057,51276,0.212043768453961,44007,234092,156022,74344,7,44,0.666498641559729,0.317584539411855,81678,0.348914102147873
RI,Washington County,44009,33511,27074,64160,0.5223036159601,0.421976309226933,6437,0.100327306733167,44009,60933,34904,24666,9,44,0.572825890732444,0.404805277928216,10238,0.168020612804228
SC,Abbeville County,45001,3712,6742,10724,0.346139500186498,0.628683327116747,3030,-0.28254382693025,45001,10577,4507,5923,1,45,0.426113264630803,0.559988654627966,1416,-0.133875389997164
SC,Aiken County,45003,25426,45981,74773,0.34004252872026,0.614941222098886,20555,-0.274898693378626,45003,66049,23953,41157,3,45,0.362654998561674,0.623128283547064,17204,-0.26047328498539
SC,Allendale County,45005,2722,788,3578,0.760760201229737,0.220234768026831,1934,0.540525433202907,45005,4257,3335,894,5,45,0.783415550857411,0.21000704721635,2441,0.573408503641062
SC,Anderson County,45007,21040,56109,80296,0.26203048719737,0.698777025007472,35069,-0.436746537810103,45007,71901,22315,48493,7,45,0.310357296838709,0.674441245601591,26178,-0.364083948762882
SC,Bamberg County,45009,3886,2197,6195,0.6272800645682,0.354640839386602,1689,0.272639225181598,45009,6854,4600,2190,9,45,0.671140939597315,0.319521447330026,2410,0.351619492267289
SC,Barnwell County,45011,4395,4888,9479,0.463656503850617,0.515666209515772,493,-0.052009705665155,45011,9913,5182,4655,11,45,0.522747906789065,0.46958539291839,527,0.053162513870675
SC,Beaufort County,45013,29577,39986,72770,0.406444963583895,0.549484677751821,10409,-0.143039714167926,45013,73115,29775,42580,13,45,0.407235177460166,0.582370238665117,12805,-0.175135061204951
SC,Berkeley County,45015,30492,44223,78919,0.386370835920374,0.560359355795182,13731,-0.173988519874808,45015,61111,24239,35764,15,45,0.396638902979824,0.585230154963918,11525,-0.188591251984095
SC,Calhoun County,45017,3569,3785,7553,0.472527472527472,0.501125380643453,216,-0.02859790811598,45017,7830,4043,3705,17,45,0.516347381864623,0.473180076628352,338,0.043167305236271
SC,Charleston County,45019,89048,75233,175850,0.506386124537958,0.42782485072505,13815,0.078561273812909,45019,160854,81027,77248,19,45,0.503730090641203,0.480236736419362,3779,0.023493354221841
SC,Cherokee County,45021,6089,15165,21754,0.279902546658086,0.697113174588581,9076,-0.417210627930496,45021,20753,7219,13306,21,45,0.347853322411218,0.641160314171445,6087,-0.293306991760227
SC,Chester County,45023,6582,7272,14202,0.463455851288551,0.512040557667934,690,-0.048584706379383,45023,14324,7839,6336,23,45,0.547263334264172,0.442334543423625,1503,0.104928790840547
SC,Chesterfield County,45025,7125,9576,17128,0.41598552078468,0.55908453993461,2451,-0.14309901914993,45025,16576,7942,8488,25,45,0.479126447876448,0.512065637065637,546,-0.032939189189189
SC,Clarendon County,45027,7635,7246,15156,0.503760886777514,0.478094484032726,389,0.025666402744788,45027,15985,8967,6890,27,45,0.560963403190491,0.431029089771661,2077,0.12993431341883
SC,Colleton County,45029,7616,9083,17231,0.441994080436423,0.527131333062504,1467,-0.085137252626081,45029,17077,8470,8439,29,45,0.495988756807402,0.494173449669146,31,0.001815307138256
SC,Darlington County,45031,13866,14973,29636,0.46787690646511,0.505230125523013,1107,-0.037353219057903,45031,30140,15452,14429,31,45,0.512674187126742,0.478732581287326,1023,0.033941605839416
SC,Dillon County,45033,5832,5637,11696,0.498632010943912,0.481959644322845,195,0.016672366621067,45033,13186,7623,5477,33,45,0.578113150310936,0.415364780828151,2146,0.162748369482785
SC,Dorchester County,45035,24010,34932,62463,0.384387557434001,0.559243071898564,10922,-0.174855514464563,45035,56735,23390,32469,35,45,0.412267559707412,0.57229223583326,9079,-0.160024676125848
SC,Edgefield County,45037,4491,6842,11644,0.385692201992442,0.587598763311577,2351,-0.201906561319134,45037,11583,4965,6511,37,45,0.428645428645429,0.562116895450229,1546,-0.1334714668048
SC,Fairfield County,45039,6936,4024,11252,0.616423746889442,0.357625311055812,2912,0.25879843583363,45039,11858,7743,3996,39,45,0.652976893236633,0.336987687637038,3747,0.315989205599595
SC,Florence County,45041,26630,29498,57770,0.460965899255669,0.510611043794357,2868,-0.049645144538688,45041,57877,28508,28825,41,45,0.492561812118804,0.4980389446585,317,-0.005477132539696
SC,Georgetown County,45043,13234,17334,31519,0.419873726958343,0.549953996002411,4100,-0.130080269044069,45043,30870,14119,16476,43,45,0.457369614512472,0.533722060252672,2357,-0.076352445740201
SC,Greenville County,45045,73338,125595,211572,0.346633770064092,0.593627701208099,52257,-0.246993931144008,45045,191282,67378,120514,45,45,0.35224433036041,0.630033144781004,53136,-0.277788814420594
SC,Greenwood County,45047,10633,16881,28600,0.371783216783217,0.590244755244755,6248,-0.218461538461538,45047,28525,11884,16290,47,45,0.416617002629273,0.571078001752848,4406,-0.154460999123576
SC,Hampton County,45049,5163,3483,8794,0.587104844211963,0.396065499204003,1680,0.19103934500796,45049,9184,5814,3310,49,45,0.633057491289199,0.360409407665505,2504,0.272648083623693
SC,Horry County,45051,36731,83819,124503,0.295021003509956,0.673228757539979,47088,-0.378207754030023,45051,104584,36620,66653,51,45,0.350149162395778,0.637315459343686,30033,-0.287166296947908
SC,Jasper County,45053,7789,6100,14216,0.54790377039955,0.429093978615644,1689,0.118809791783906,45053,9991,5727,4169,53,45,0.573215894304874,0.417275547993194,1558,0.155940346311681
SC,Kershaw County,45055,10293,17464,28875,0.356467532467532,0.604813852813853,7171,-0.24834632034632,45055,27026,10821,15846,55,45,0.400392214904166,0.586324280322652,5025,-0.185932065418486
SC,Lancaster County,45057,13718,23598,38717,0.35431464214686,0.609499702972854,9880,-0.255185060825994,45057,33010,13345,19273,57,45,0.404271432899122,0.583853377764314,5928,-0.179581944865192
SC,Laurens County,45059,8845,16770,26474,0.334101382488479,0.633451688449044,7925,-0.299350305960565,45059,25373,10297,14726,59,45,0.405825089662239,0.580380719662634,4429,-0.174555630000394
SC,Lee County,45061,5170,2789,8110,0.637484586929716,0.343896424167694,2381,0.293588162762022,45061,8898,5972,2829,61,45,0.671162058889638,0.317936614969656,3143,0.353225443919982
SC,Lexington County,45063,35143,79866,121829,0.288461696312044,0.655558200428469,44723,-0.367096504116425,45063,112204,34007,76392,63,45,0.303081886563759,0.680831342911126,42385,-0.377749456347367
SC,McCormick County,45065,2479,2651,5215,0.47535953978907,0.508341323106424,172,-0.032981783317354,45065,5137,2637,2460,65,45,0.51333463110765,0.478878722990072,177,0.034455908117579
SC,Marion County,45067,8522,5434,14217,0.599423225715692,0.382218470844763,3088,0.217204754870929,45067,14766,9518,5114,67,45,0.644588920493024,0.34633617770554,4404,0.298252742787485
SC,Marlboro County,45069,5928,4257,10353,0.572587655751956,0.411185163720661,1671,0.161402492031295,45069,11657,7554,4010,69,45,0.648022647336364,0.34399931371708,3544,0.304023333619284
SC,Newberry County,45071,6212,10011,16795,0.369871985710033,0.596070259005656,3799,-0.226198273295624,45071,16287,6891,9218,71,45,0.423098176459753,0.565972861791613,2327,-0.14287468533186
SC,Oconee County,45073,7979,24096,33530,0.237966000596481,0.718640023859231,16117,-0.48067402326275,45073,30613,8537,21573,73,45,0.27886845457812,0.704700617384771,13036,-0.425832162806651
SC,Orangeburg County,45075,26258,11909,38824,0.676334226251803,0.30674325159695,14349,0.369590974654853,45075,42637,30454,11888,75,45,0.714262260477989,0.278818866242935,18566,0.435443394235054
SC,Pickens County,45077,10327,36096,48871,0.211311411675636,0.738597532278857,25769,-0.527286120603221,45077,45422,11122,33385,77,45,0.244859319272599,0.734996257320241,22263,-0.490136938047642
SC,Richland County,45079,108401,52753,169400,0.639911452184179,0.311410861865407,55648,0.328500590318772,45079,143016,94350,46725,79,45,0.65971639536835,0.326711696593388,47625,0.333004698774962
SC,Saluda County,45081,2809,5525,8559,0.328192545858161,0.645519336371071,2716,-0.31732679051291,45081,8553,3322,5130,81,45,0.388401730386999,0.599789547527184,1808,-0.211387817140185
SC,Spartanburg County,45083,39888,76101,120793,0.330217810634722,0.630011672861838,36213,-0.299793862227116,45083,108327,40920,65951,83,45,0.377745160486305,0.60881405374468,25031,-0.231068893258375
SC,Sumter County,45085,24024,18733,44048,0.545405012713404,0.425286051580094,5291,0.120118961133309,45085,47261,27550,19266,85,45,0.582933073781765,0.407651128837731,8284,0.175281944944034
SC,Union County,45087,4727,7058,12087,0.391081327045586,0.5839331513196,2331,-0.192851824274013,45087,12475,5748,6566,87,45,0.460761523046092,0.526332665330661,818,-0.065571142284569
SC,Williamsburg County,45089,9949,4863,15049,0.661107050302346,0.32314439497641,5086,0.337962655325935,45089,16282,11318,4819,89,45,0.695123449207714,0.295971010932318,6499,0.399152438275396
SC,York County,45091,41230,66245,113425,0.363500110204981,0.584042318712806,25015,-0.220542208507824,45091,99428,38757,59149,91,45,0.389799654021,0.594892786740154,20392,-0.205093132719154
SD,Aurora County,46003,340,974,1407,0.241648898365316,0.69225302061123,634,-0.450604122245913,46003,1400,556,804,3,46,0.397142857142857,0.574285714285714,248,-0.177142857142857
SD,Beadle County,46005,1912,4455,6772,0.282339043118724,0.65785587714117,2543,-0.375516834022445,46005,7263,2881,4230,5,46,0.396668043508192,0.582403965303593,1349,-0.185735921795401
SD,Bennett County,46007,412,666,1149,0.358572671888599,0.579634464751958,254,-0.221061792863359,46007,1203,548,626,7,46,0.455527847049044,0.520365752285952,78,-0.064837905236908
SD,Bon Homme County,46009,704,2105,2974,0.236718224613315,0.707800941492939,1401,-0.471082716879623,46009,3074,1167,1830,9,46,0.379635653871178,0.595315549772284,663,-0.215679895901106
SD,Brookings County,46011,4879,6748,12680,0.384779179810726,0.532176656151419,1869,-0.147397476340694,46011,12398,5826,6219,11,46,0.469914502339087,0.501613163413454,393,-0.031698661074367
SD,Brown County,46013,5452,9613,16113,0.338360330168187,0.596599019425309,4161,-0.258238689257122,46013,16066,7249,8320,13,46,0.45120129465953,0.517863811776422,1071,-0.066662517116893
SD,Brule County,46015,571,1565,2288,0.249562937062937,0.684003496503496,994,-0.434440559440559,46015,2379,824,1499,15,46,0.346364018495166,0.630096679277007,675,-0.283732660781841
SD,Buffalo County,46017,296,171,490,0.604081632653061,0.348979591836735,125,0.255102040816327,46017,641,472,166,17,46,0.736349453978159,0.258970358814353,306,0.477379095163806
SD,Butte County,46019,693,3355,4346,0.15945697192821,0.771974229176254,2662,-0.612517257248044,46019,4201,1000,3068,19,46,0.238038562247084,0.730302308974054,2068,-0.49226374672697
SD,Campbell County,46021,105,704,831,0.126353790613718,0.847172081829121,599,-0.720818291215403,46021,787,153,616,21,46,0.19440914866582,0.782719186785261,463,-0.588310038119441
SD,Charles Mix County,46023,935,2382,3433,0.272356539469851,0.693853772210894,1447,-0.421497232741043,46023,3762,1482,2229,23,46,0.393939393939394,0.592503987240829,747,-0.198564593301435
SD,Clark County,46025,398,1139,1657,0.24019312009656,0.687386843693422,741,-0.447193723596862,46025,1821,713,1067,25,46,0.391543108182317,0.585941790225151,354,-0.194398682042834
SD,Clay County,46027,2608,2109,5069,0.514499901361215,0.416058394160584,499,0.098441507200631,46027,5233,2955,2146,27,46,0.564685648767437,0.410089814637875,809,0.154595834129562
SD,Codington County,46029,3174,7764,11669,0.272002742308681,0.665352643756963,4590,-0.393349901448282,46029,11524,4588,6696,29,46,0.398125650815689,0.581048247136411,2108,-0.182922596320722
SD,Corson County,46031,535,588,1175,0.45531914893617,0.500425531914894,53,-0.045106382978723,46031,1199,647,515,31,46,0.539616346955796,0.429524603836531,132,0.110091743119266
SD,Custer County,46033,1120,3290,4716,0.237489397794741,0.697625106022053,2170,-0.460135708227311,46033,4520,1335,3062,33,46,0.295353982300885,0.677433628318584,1727,-0.382079646017699
SD,Davison County,46035,2355,5157,7952,0.296151911468813,0.648516096579477,2802,-0.352364185110664,46035,7968,3042,4754,35,46,0.381777108433735,0.596636546184739,1712,-0.214859437751004
SD,Day County,46037,974,1627,2747,0.354568620313069,0.592282489989079,653,-0.23771386967601,46037,2873,1497,1320,37,46,0.521058127392969,0.459450052210233,177,0.061608075182736
SD,Deuel County,46039,570,1366,2080,0.274038461538462,0.656730769230769,796,-0.382692307692308,46039,2171,941,1175,39,46,0.43344081068632,0.541225241824044,234,-0.107784431137725
SD,Dewey County,46041,887,723,1707,0.519625073227885,0.423550087873462,164,0.096074985354423,46041,1895,1207,663,41,46,0.636939313984169,0.349868073878628,544,0.287071240105541
SD,Douglas County,46043,214,1338,1605,0.133333333333333,0.833644859813084,1124,-0.700311526479751,46043,1690,332,1334,43,46,0.196449704142012,0.789349112426035,1002,-0.592899408284024
SD,Edmunds County,46045,380,1433,1918,0.198123044838373,0.747132429614181,1053,-0.549009384775808,46045,1936,622,1264,45,46,0.321280991735537,0.652892561983471,642,-0.331611570247934
SD,Fall River County,46047,821,2511,3563,0.230423800168397,0.704743193937693,1690,-0.474319393769296,46047,3511,1137,2256,47,46,0.323839362005127,0.642551979493022,1119,-0.318712617487895
SD,Faulk County,46049,204,858,1118,0.182468694096601,0.767441860465116,654,-0.584973166368515,46049,1127,331,765,49,46,0.293700088731145,0.678793256433008,434,-0.385093167701863
SD,Grant County,46051,970,2381,3562,0.272318921953958,0.668444693992139,1411,-0.396125772038181,46051,3606,1493,2034,51,46,0.414032168607876,0.564059900166389,541,-0.150027731558514
SD,Gregory County,46053,391,1600,2091,0.186991869918699,0.765184122429459,1209,-0.57819225251076,46053,2151,599,1507,53,46,0.278475127847513,0.700604370060437,908,-0.422129242212924
SD,Haakon County,46055,77,936,1044,0.073754789272031,0.896551724137931,859,-0.8227969348659,46055,1092,138,940,55,46,0.126373626373626,0.860805860805861,802,-0.734432234432235
SD,Hamlin County,46057,555,2051,2762,0.200941346850109,0.742577842143374,1496,-0.541636495293266,46057,2793,921,1803,57,46,0.329752953813104,0.645542427497315,882,-0.31578947368421
SD,Hand County,46059,334,1391,1818,0.183718371837184,0.765126512651265,1057,-0.581408140814081,46059,1848,575,1242,59,46,0.311147186147186,0.672077922077922,667,-0.360930735930736
SD,Hanson County,46061,424,1497,2006,0.211365902293121,0.746261216350947,1073,-0.534895314057827,46061,2416,760,1627,61,46,0.314569536423841,0.673427152317881,867,-0.35885761589404
SD,Harding County,46063,38,694,769,0.049414824447334,0.902470741222367,656,-0.853055916775032,46063,739,82,638,63,46,0.110960757780785,0.863328822733424,556,-0.752368064952639
SD,Hughes County,46065,2449,5174,8173,0.299645173131041,0.633060075859537,2725,-0.333414902728496,46065,8155,2786,5219,65,46,0.341630901287554,0.639975475168608,2433,-0.298344573881055
SD,Hutchinson County,46067,692,2517,3365,0.205646359583952,0.747994056463596,1825,-0.542347696879643,46067,3425,923,2451,67,46,0.26948905109489,0.715620437956204,1528,-0.446131386861314
SD,Hyde County,46069,125,543,690,0.181159420289855,0.78695652173913,418,-0.605797101449275,46069,733,189,531,69,46,0.257844474761255,0.724420190995907,342,-0.466575716234652
SD,Jackson County,46071,323,722,1095,0.294977168949772,0.659360730593607,399,-0.364383561643836,46071,1106,426,661,71,46,0.385171790235081,0.597649186256781,235,-0.2124773960217
SD,Jerauld County,46073,264,648,967,0.27300930713547,0.670113753877973,384,-0.397104446742503,46073,1006,452,538,73,46,0.449304174950298,0.534791252485089,86,-0.085487077534791
SD,Jones County,46075,69,450,558,0.123655913978495,0.806451612903226,381,-0.682795698924731,46075,609,108,490,75,46,0.177339901477833,0.804597701149425,382,-0.627257799671593
SD,Kingsbury County,46077,703,1680,2551,0.275578204625637,0.658565268522148,977,-0.382987063896511,46077,2608,1092,1451,77,46,0.418711656441718,0.556365030674847,359,-0.137653374233129
SD,Lake County,46079,2314,4038,6786,0.340996168582376,0.595048629531388,1724,-0.254052460949013,46079,6285,2724,3419,79,46,0.433412887828162,0.543993635640414,695,-0.110580747812251
SD,Lawrence County,46081,3356,7411,11842,0.283398074649552,0.625823340651917,4055,-0.342425266002364,46081,11359,3973,7025,81,46,0.349766704815565,0.618452328550048,3052,-0.268685623734484
SD,Lincoln County,46083,8076,15499,25231,0.320082438270382,0.614284015694978,7423,-0.294201577424597,46083,21952,7982,13611,83,46,0.363611516034985,0.620034620991254,5629,-0.256423104956268
SD,Lyman County,46085,369,977,1421,0.259676284306826,0.687543983110486,608,-0.427867698803659,46085,1569,605,933,85,46,0.38559592096877,0.594646271510516,328,-0.209050350541746
SD,McCook County,46087,623,1794,2587,0.240819482025512,0.693467336683417,1171,-0.452647854657905,46087,2613,905,1655,87,46,0.346345197091466,0.633371603520857,750,-0.287026406429392
SD,McPherson County,46089,192,892,1137,0.168865435356201,0.784520668425682,700,-0.615655233069481,46089,1215,272,921,89,46,0.223868312757202,0.758024691358025,649,-0.534156378600823
SD,Marshall County,46091,754,1056,1947,0.387262455059065,0.542372881355932,302,-0.155110426296867,46091,1987,1061,889,91,46,0.533970810266734,0.447408152994464,172,0.08656265727227
SD,Meade County,46093,2223,8441,11621,0.191291627226573,0.726357456329059,6218,-0.535065829102487,46093,10811,2928,7560,93,46,0.270835260382943,0.699287762464157,4632,-0.428452502081214
SD,Mellette County,46095,238,402,683,0.348462664714495,0.588579795021962,164,-0.240117130307467,46095,769,375,381,95,46,0.487646293888166,0.495448634590377,6,-0.007802340702211
SD,Miner County,46097,281,706,1064,0.264097744360902,0.663533834586466,425,-0.399436090225564,46097,1140,479,636,97,46,0.420175438596491,0.557894736842105,157,-0.137719298245614
SD,Minnehaha County,46099,30610,42043,78263,0.391117130700331,0.537201487292846,11433,-0.146084356592515,46099,76565,34668,40330,99,46,0.452791745575655,0.526741983935218,5662,-0.073950238359564
SD,Moody County,46101,1042,1729,2930,0.355631399317406,0.590102389078498,687,-0.234470989761092,46101,3033,1429,1535,101,46,0.47115067589845,0.50609957138147,106,-0.03494889548302
SD,Pennington County,46103,14074,29804,47741,0.294799019710521,0.624285205588488,15730,-0.329486185877967,46103,44458,15122,28229,103,46,0.34014125691664,0.634958837554546,13107,-0.294817580637905
SD,Perkins County,46105,188,1333,1606,0.11706102117061,0.830012453300125,1145,-0.712951432129514,46105,1590,319,1205,105,46,0.20062893081761,0.757861635220126,886,-0.557232704402516
SD,Potter County,46107,215,1069,1335,0.161048689138577,0.800749063670412,854,-0.639700374531835,46107,1381,339,1029,107,46,0.245474293989862,0.745112237509051,690,-0.499637943519189
SD,Roberts County,46109,1539,2142,3886,0.396037056098816,0.55120946989192,603,-0.155172413793103,46109,4256,2302,1883,109,46,0.540883458646617,0.442434210526316,419,0.098449248120301
SD,Sanborn County,46111,241,819,1123,0.214603739982191,0.729296527159395,578,-0.514692787177204,46111,1115,389,688,111,46,0.348878923766816,0.617040358744395,299,-0.268161434977579
SD,Oglala County,46113,2504,241,2896,0.8646408839779,0.083218232044199,2263,0.781422651933702,46113,3130,2922,188,113,46,0.933546325878594,0.060063897763578,2734,0.873482428115016
SD,Spink County,46115,919,1854,2951,0.311419857675364,0.628261606235174,935,-0.31684174855981,46115,3041,1300,1670,115,46,0.427490956922065,0.549161460046038,370,-0.121670503123972
SD,Stanley County,46117,329,1148,1567,0.209955328653478,0.732610082961072,819,-0.522654754307594,46117,1540,435,1063,117,46,0.282467532467532,0.69025974025974,628,-0.407792207792208
SD,Sully County,46119,137,679,861,0.159117305458769,0.788617886178862,542,-0.629500580720093,46119,816,186,611,119,46,0.227941176470588,0.748774509803922,425,-0.520833333333333
SD,Todd County,46121,1505,487,2125,0.708235294117647,0.229176470588235,1018,0.479058823529412,46121,2497,1976,498,121,46,0.791349619543452,0.199439327192631,1478,0.591910292350821
SD,Tripp County,46123,462,2069,2630,0.175665399239544,0.786692015209125,1607,-0.611026615969582,46123,2691,737,1905,123,46,0.273875882571535,0.707915273132664,1168,-0.43403939056113
SD,Turner County,46125,961,2937,4150,0.231566265060241,0.707710843373494,1976,-0.476144578313253,46125,4210,1411,2715,125,46,0.335154394299287,0.644893111638955,1304,-0.309738717339668
SD,Union County,46127,2227,5288,7895,0.282077264091197,0.669791006966434,3061,-0.387713742875237,46127,7596,2782,4698,127,46,0.366245392311743,0.618483412322275,1916,-0.252238020010532
SD,Walworth County,46129,457,1896,2477,0.184497375857893,0.765442067016552,1439,-0.58094469115866,46129,2462,671,1731,129,46,0.272542648253452,0.703086921202275,1060,-0.430544272948822
SD,Yankton County,46135,3301,5654,9616,0.343282029950083,0.587978369384359,2353,-0.244696339434276,46135,9924,4208,5463,135,46,0.424022571543732,0.550483675937122,1255,-0.12646110439339
SD,Ziebach County,46137,352,368,766,0.459530026109661,0.480417754569191,16,-0.02088772845953,46137,761,439,314,137,46,0.576872536136662,0.412614980289093,125,0.164257555847569
TN,Anderson County,47001,9010,19201,29723,0.30313225448306,0.645998048649194,10191,-0.342865794166134,47001,29621,10112,18941,1,47,0.341379426758043,0.639444988352858,8829,-0.298065561594814
TN,Bedford County,47003,3384,11455,15300,0.221176470588235,0.748692810457516,8071,-0.527516339869281,47003,14433,4207,10026,3,47,0.291484791796577,0.694658075244232,5819,-0.403173283447655
TN,Benton County,47005,1474,4715,6322,0.23315406516925,0.745808288516292,3241,-0.512654223347042,47005,6223,2255,3850,5,47,0.362365418608388,0.61867266591676,1595,-0.256307247308372
TN,Bledsoe County,47007,896,3621,4650,0.192688172043011,0.778709677419355,2725,-0.586021505376344,47007,4359,1267,3022,7,47,0.290662996100023,0.693278274833677,1755,-0.402615278733655
TN,Blount County,47009,12085,37385,51849,0.233080676580069,0.721036085556134,25300,-0.487955408976065,47009,49200,12925,35417,9,47,0.26270325203252,0.719857723577236,22492,-0.457154471544715
TN,Bradley County,47011,7070,29761,38392,0.184152948530944,0.77518753907064,22691,-0.591034590539696,47011,35956,8035,27417,11,47,0.223467571476249,0.762515296473468,19382,-0.539047724997219
TN,Campbell County,47013,2248,9860,12504,0.179782469609725,0.788547664747281,7612,-0.608765195137556,47013,12097,3327,8602,13,47,0.275026866165165,0.711085393072663,5275,-0.436058526907498
TN,Cannon County,47015,1126,4006,5299,0.212492923193055,0.755991696546518,2880,-0.543498773353463,47015,4968,1560,3308,15,47,0.314009661835749,0.665861513687601,1748,-0.351851851851852
TN,Carroll County,47017,2323,7731,10333,0.22481370366786,0.748185425336301,5408,-0.523371721668441,47017,10845,3475,7219,17,47,0.320424158598432,0.665652374366067,3744,-0.345228215767635
TN,Carter County,47019,3453,16897,20993,0.164483399228314,0.804887343400181,13444,-0.640403944171867,47019,20607,4786,15496,19,47,0.232251176784588,0.751977483379434,10710,-0.519726306594846
TN,Cheatham County,47021,3877,11295,15823,0.245023067686279,0.713834291853631,7418,-0.468811224167351,47021,15177,4656,10266,21,47,0.30677999604665,0.676418264479146,5610,-0.369638268432497
TN,Chester County,47023,902,3827,4850,0.185979381443299,0.789072164948454,2925,-0.603092783505155,47023,6396,1622,4672,23,47,0.253595997498437,0.730456535334584,3050,-0.476860537836148
TN,Claiborne County,47025,1831,8589,10706,0.17102559312535,0.802260414720717,6758,-0.631234821595367,47025,10178,2433,7617,25,47,0.239044999017489,0.748378856356848,5184,-0.509333857339359
TN,Clay County,47027,707,2140,2919,0.24220623501199,0.733127783487496,1433,-0.490921548475505,47027,2820,1037,1747,27,47,0.367730496453901,0.619503546099291,710,-0.25177304964539
TN,Cocke County,47029,1980,9791,12108,0.163528245787909,0.808638916418897,7811,-0.645110670630988,47029,11450,2804,8459,29,47,0.244890829694323,0.738777292576419,5655,-0.493886462882096
TN,Coffee County,47031,4741,14409,19895,0.238301080673536,0.7242523247047,9668,-0.485951244031164,47031,19242,5865,13013,31,47,0.304801995634549,0.67628105186571,7148,-0.371479056231161
TN,Crockett County,47033,1302,3977,5386,0.241737838841441,0.738395841069439,2675,-0.496658002227999,47033,5497,1669,3782,33,47,0.303620156448972,0.688011642714208,2113,-0.384391486265236
TN,Cumberland County,47035,5202,20410,26298,0.197809719370294,0.776104646741197,15208,-0.578294927370903,47035,25244,6260,18651,35,47,0.247979717952781,0.738829028680082,12391,-0.490849310727302
TN,Davidson County,47037,148473,84365,246199,0.603060938509092,0.342669953980317,64108,0.260390984528776,47037,237372,138899,94464,37,47,0.585153261547276,0.397957636115464,44435,0.187195625431812
TN,Decatur County,47039,894,3580,4577,0.1953244483286,0.782171728206249,2686,-0.586847279877649,47039,4248,1302,2873,39,47,0.306497175141243,0.676318267419962,1571,-0.369821092278719
TN,DeKalb County,47041,1566,5164,6940,0.225648414985591,0.744092219020173,3598,-0.518443804034582,47041,6406,2168,4134,41,47,0.338432719325632,0.645332500780518,1966,-0.306899781454886
TN,Dickson County,47043,4718,13213,18619,0.253397067511682,0.709651431333584,8495,-0.456254363821902,47043,17821,6228,11287,43,47,0.349475338084283,0.63335390831042,5059,-0.283878570226138
TN,Dyer County,47045,2815,10175,13290,0.211813393528969,0.76561324303988,7360,-0.55379984951091,47045,13800,3757,9921,45,47,0.272246376811594,0.718913043478261,6164,-0.446666666666667
TN,Fayette County,47047,5865,13046,19306,0.303791567388377,0.675748471977624,7181,-0.371956904589247,47047,19562,6683,12682,47,47,0.341631734996422,0.648297720069523,5999,-0.306665985073101
TN,Fentress County,47049,1100,6032,7311,0.150458213650663,0.825058131582547,4932,-0.674599917931883,47049,6890,1559,5240,49,47,0.226269956458636,0.760522496371553,3681,-0.534252539912917
TN,Franklin County,47051,4372,11526,16363,0.267188168428772,0.704394059768991,7154,-0.437205891340219,47051,16099,5594,10252,51,47,0.347474998447108,0.636809739735387,4658,-0.289334741288279
TN,Gibson County,47053,5255,13779,19484,0.269708478751796,0.707195647710942,8524,-0.437487168959146,47053,19667,6564,12883,53,47,0.33375705496517,0.65505669395434,6319,-0.32129963898917
TN,Giles County,47055,2915,7964,11120,0.262140287769784,0.716187050359712,5049,-0.454046762589928,47055,10797,3759,6914,55,47,0.348152264517922,0.640363063814022,3155,-0.292210799296101
TN,Grainger County,47057,1154,6618,7985,0.144520976831559,0.828804007514089,5464,-0.68428303068253,47057,7250,1668,5469,57,47,0.230068965517241,0.754344827586207,3801,-0.524275862068966
TN,Greene County,47059,4211,18538,23491,0.179260142182112,0.789153292750415,14327,-0.609893150568303,47059,23937,6216,17234,59,47,0.259681664368969,0.7199732631491,11018,-0.460291598780131
TN,Grundy County,47061,998,3626,4750,0.210105263157895,0.763368421052632,2628,-0.553263157894737,47061,4217,1637,2502,61,47,0.38819065686507,0.593312781598293,865,-0.205122124733223
TN,Hamblen County,47063,4075,15839,20579,0.198017396374945,0.769668108265708,11764,-0.571650711890762,47063,20020,5229,14515,63,47,0.261188811188811,0.725024975024975,9286,-0.463836163836164
TN,Hamilton County,47065,55260,78661,141088,0.391670446813336,0.557531469721025,23401,-0.165861022907689,47065,142320,58794,79877,65,47,0.413111298482293,0.561249297358066,21083,-0.148137998875773
TN,Hancock County,47067,322,1842,2229,0.144459398833558,0.826379542395693,1520,-0.681920143562135,47067,2046,475,1527,67,47,0.232160312805474,0.74633431085044,1052,-0.514173998044966
TN,Hardeman County,47069,4174,4912,9242,0.45163384548799,0.531486691192383,738,-0.079852845704393,47069,10435,5479,4864,69,47,0.525059894585529,0.466123622424533,615,0.058936272160997
TN,Hardin County,47071,1622,8012,9949,0.163031460448286,0.805307066036788,6390,-0.642275605588501,47071,10495,2467,7886,71,47,0.235064316341115,0.751405431157694,5419,-0.516341114816579
TN,Hawkins County,47073,3502,16611,20694,0.169227795496279,0.802696433748913,13109,-0.633468638252634,47073,19789,5086,14376,73,47,0.257011471019253,0.726464197281318,9290,-0.469452726262065
TN,Haywood County,47075,3704,3010,6824,0.542790152403282,0.441090269636577,694,0.101699882766706,47075,7567,4567,2960,75,47,0.603541694198493,0.391172195057487,1607,0.212369499141007
TN,Henderson County,47077,1796,8118,10172,0.176563114431773,0.798073141958317,6322,-0.621510027526543,47077,10051,2516,7418,77,47,0.250323350910357,0.738036016316784,4902,-0.487712665406427
TN,Henry County,47079,3061,9483,12887,0.237526189182897,0.735857841235353,6422,-0.498331652052456,47079,12731,4337,8187,79,47,0.34066451967638,0.643075956327076,3850,-0.302411436650695
TN,Hickman County,47081,1823,5685,7762,0.234862148930688,0.732414326204586,3862,-0.497552177273898,47081,7595,2693,4756,81,47,0.354575378538512,0.626201448321264,2063,-0.271626069782752
TN,Houston County,47083,865,2180,3165,0.273301737756714,0.688783570300158,1315,-0.415481832543444,47083,3027,1400,1579,83,47,0.462504129501156,0.521638586058804,179,-0.059134456557648
TN,Humphreys County,47085,1967,4928,7139,0.275528785544194,0.690292758089368,2961,-0.414763972545174,47085,6860,2904,3829,85,47,0.42332361516035,0.558163265306122,925,-0.134839650145773
TN,Jackson County,47087,1129,3229,4447,0.253879019563751,0.726107488194288,2100,-0.472228468630537,47087,4178,1736,2380,87,47,0.415509813307803,0.569650550502633,644,-0.15414073719483
TN,Jefferson County,47089,3490,14760,18994,0.183742234389807,0.777087501316205,11270,-0.593345266926398,47089,17565,4230,13037,89,47,0.240819812126388,0.7422146313692,8807,-0.501394819242812
TN,Johnson County,47091,988,5400,6556,0.150701647345943,0.823672971323978,4412,-0.672971323978035,47091,6194,1483,4611,91,47,0.23942525024217,0.744430093639005,3128,-0.505004843396836
TN,Knox County,47093,62861,105724,179266,0.350657681880557,0.589760467684893,42863,-0.239102785804335,47093,167330,57594,106411,93,47,0.34419410745234,0.635934978784438,48817,-0.291740871332098
TN,Lake County,47095,577,1357,1970,0.292893401015228,0.688832487309645,780,-0.395939086294416,47095,2087,884,1163,95,47,0.423574508864399,0.557259223766172,279,-0.133684714901773
TN,Lauderdale County,47097,3656,4884,8678,0.421295229315511,0.562802489052777,1228,-0.141507259737267,47097,8688,4010,4616,97,47,0.461556169429098,0.531307550644567,606,-0.06975138121547
TN,Lawrence County,47099,2821,12419,15658,0.180163494699195,0.793140886447822,9598,-0.612977391748627,47099,15219,4237,10770,99,47,0.278401997503121,0.707668046520796,6533,-0.429266049017675
TN,Lewis County,47101,890,3579,4601,0.19343620951967,0.77787437513584,2689,-0.58443816561617,47101,4691,1445,3116,101,47,0.308036665956086,0.664250692816031,1671,-0.356214026859944
TN,Lincoln County,47103,2550,10375,13270,0.19216277317257,0.781838733986436,7825,-0.589675960813866,47103,13249,3283,9791,103,47,0.24779228621028,0.73899916974866,6508,-0.49120688353838
TN,Loudon County,47105,4916,17588,23304,0.21095090971507,0.754720219704772,12672,-0.543769309989701,47105,22066,5057,16701,105,47,0.229176108039518,0.756865766337352,11644,-0.527689658297834
TN,McMinn County,47107,3507,14673,18694,0.187600299561357,0.784904247352092,11166,-0.597303947790735,47107,17818,4603,12958,107,47,0.258334268717028,0.727242114715456,8355,-0.468907845998429
TN,McNairy County,47109,1847,7839,10035,0.184055804683607,0.781165919282511,5992,-0.597110114598904,47109,9809,2643,7010,109,47,0.269446426750943,0.714649811397696,4367,-0.445203384646753
TN,Macon County,47111,1071,6260,7490,0.142990654205607,0.835781041388518,5189,-0.692790387182911,47111,6904,1552,5259,111,47,0.224797219003476,0.761732329084589,3707,-0.536935110081112
TN,Madison County,47113,15438,21321,37764,0.408802033682873,0.564585319351764,5883,-0.155783285668891,47113,40691,18360,21989,113,47,0.451205426261335,0.540389766778895,3629,-0.089184340517559
TN,Marion County,47115,2829,7680,10832,0.261170605612999,0.709010339734121,4851,-0.447839734121123,47115,10404,3952,6268,115,47,0.379853902345252,0.602460592079969,2316,-0.222606689734717
TN,Marshall County,47117,2848,8167,11402,0.249780740221014,0.716277845991931,5319,-0.466497105770917,47117,10729,3722,6823,117,47,0.346910243265915,0.635939975766614,3101,-0.289029732500699
TN,Maury County,47119,10026,23781,35068,0.285901676742329,0.678139614463328,13755,-0.392237937720999,47119,32989,11819,20698,119,47,0.358270938797781,0.627421261632665,8879,-0.269150322834884
TN,Meigs County,47121,856,3337,4311,0.198561818603572,0.774066341916029,2481,-0.575504523312457,47121,3958,1163,2728,121,47,0.293835270338555,0.689236988377969,1565,-0.395401718039414
TN,Monroe County,47123,3184,13361,17050,0.186744868035191,0.783636363636364,10177,-0.596891495601173,47123,16320,4368,11717,123,47,0.267647058823529,0.717953431372549,7349,-0.45030637254902
TN,Montgomery County,47125,21686,32320,57278,0.378609588323615,0.564265512063969,10634,-0.185655923740354,47125,55424,24349,30159,125,47,0.439322315242494,0.544150548498845,5810,-0.104828233256351
TN,Moore County,47127,496,2325,2926,0.169514695830485,0.7946001367054,1829,-0.625085440874915,47127,2799,705,2053,127,47,0.251875669882101,0.733476241514827,1348,-0.481600571632726
TN,Morgan County,47129,1053,5429,6664,0.158013205282113,0.814675870348139,4376,-0.656662665066026,47129,6500,1722,4668,129,47,0.264923076923077,0.718153846153846,2946,-0.453230769230769
TN,Obion County,47131,2425,9525,12223,0.198396465679457,0.779268591998691,7100,-0.580872126319234,47131,12296,3320,8814,131,47,0.270006506180872,0.716818477553676,5494,-0.446811971372804
TN,Overton County,47133,1943,6055,8195,0.237095790115924,0.738865161683954,4112,-0.501769371568029,47133,7657,2802,4772,133,47,0.365939663053415,0.623220582473554,1970,-0.257280919420138
TN,Perry County,47135,597,2167,2855,0.209106830122592,0.759019264448336,1570,-0.549912434325744,47135,2621,992,1578,135,47,0.378481495612362,0.602060282334987,586,-0.223578786722625
TN,Pickett County,47137,536,2019,2609,0.205442698351859,0.773859716366424,1483,-0.568417018014565,47137,2446,711,1707,137,47,0.290678659035159,0.697874080130826,996,-0.407195421095666
TN,Polk County,47139,1252,5097,6520,0.192024539877301,0.781748466257669,3845,-0.589723926380368,47139,6059,1856,4108,139,47,0.306321175111404,0.677999669912527,2252,-0.371678494801122
TN,Putnam County,47141,6847,18981,26958,0.253987684546331,0.704095259292232,12134,-0.450107574745901,47141,25479,7793,17242,141,47,0.305859727618823,0.676714156756545,9449,-0.370854429137721
TN,Rhea County,47143,1942,8650,10946,0.177416407820208,0.790243011145624,6708,-0.612826603325416,47143,10578,2625,7793,143,47,0.248156551332955,0.736717716014369,5168,-0.488561164681414
TN,Roane County,47145,4833,15863,21580,0.223957367933272,0.735078776645042,11030,-0.51112140871177,47145,21081,6014,14719,145,47,0.285280584412504,0.698211659788435,8705,-0.412931075375931
TN,Robertson County,47147,6634,19393,27042,0.245322091561275,0.717143702388877,12759,-0.471821610827602,47147,26285,8289,17641,147,47,0.31535096062393,0.671143237587978,9352,-0.355792276964048
TN,Rutherford County,47149,36627,64428,106518,0.343857376218104,0.604855517377345,27801,-0.260998141159241,47149,98816,36400,60829,149,47,0.368361398963731,0.615578448834197,24429,-0.247217049870466
TN,Scott County,47151,934,6044,7123,0.131124526182788,0.848518882493332,5110,-0.717394356310543,47151,6668,1452,5117,151,47,0.217756448710258,0.767396520695861,3665,-0.549640071985603
TN,Sequatchie County,47153,1051,4434,5667,0.185459678842421,0.782424563260985,3383,-0.596964884418563,47153,5141,1488,3541,153,47,0.289437852557868,0.688776502625948,2053,-0.39933865006808
TN,Sevier County,47155,6293,28610,36180,0.173935876174682,0.790768380320619,22317,-0.616832504145937,47155,33856,7415,25979,155,47,0.219015831758034,0.767338137996219,18564,-0.548322306238185
TN,Shelby County,47157,206640,114948,331861,0.622670334869117,0.346373933664998,91692,0.276296401204119,47157,370749,232201,135536,157,47,0.626302431024763,0.365573474237287,96665,0.260728956787476
TN,Smith County,47159,1688,5485,7410,0.227800269905533,0.740215924426451,3797,-0.512415654520918,47159,7081,2467,4492,159,47,0.348397119050981,0.634373676034458,2025,-0.285976556983477
TN,Stewart County,47161,1222,3864,5283,0.231307968957032,0.731402612152186,2642,-0.500094643195154,47161,5115,2069,2963,161,47,0.404496578690127,0.579276637341153,894,-0.174780058651026
TN,Sullivan County,47163,11910,45577,59860,0.198964249916472,0.761393250918811,33667,-0.562429001002339,47163,59833,15303,43528,163,47,0.255761870539669,0.727491518058596,28225,-0.471729647518928
TN,Sumner County,47165,18153,50105,71080,0.25538829487901,0.704909960607766,31952,-0.449521665728756,47165,65334,18571,45979,165,47,0.284247099519393,0.703753022928337,27408,-0.419505923408945
TN,Tipton County,47167,5779,16893,23372,0.247261680643505,0.722787951394831,11114,-0.475526270751326,47167,23682,7020,16395,167,47,0.296427666582214,0.692297947808462,9375,-0.395870281226248
TN,Trousdale County,47169,943,2099,3142,0.300127307447486,0.668045830681095,1156,-0.367918523233609,47169,2901,1238,1610,169,47,0.426749396759738,0.554981041020338,372,-0.1282316442606
TN,Unicoi County,47171,1260,5666,7166,0.17583030979626,0.7906782026235,4406,-0.61484789282724,47171,7078,1909,5028,171,47,0.26970895733258,0.710370161062447,3119,-0.440661203729867
TN,Union County,47173,1010,5024,6204,0.162798194713088,0.809800128949065,4014,-0.647001934235977,47173,5820,1474,4278,173,47,0.253264604810997,0.735051546391753,2804,-0.481786941580756
TN,Van Buren County,47175,539,1820,2417,0.223003723624328,0.752999586263964,1281,-0.529995862639636,47175,2298,875,1384,175,47,0.380765883376849,0.602262837249783,509,-0.221496953872933
TN,Warren County,47177,3535,9535,13565,0.260597124953926,0.702911905639513,6000,-0.442314780685588,47177,13008,4748,8007,177,47,0.365006150061501,0.615544280442804,3259,-0.250538130381304
TN,Washington County,47179,13003,34179,49411,0.263160025095627,0.691728562465848,21176,-0.428568537370221,47179,48003,14318,32787,179,47,0.298273024602629,0.683019811261796,18469,-0.384746786659167
TN,Wayne County,47181,717,5034,5842,0.122731941116056,0.861691201643273,4317,-0.738959260527217,47181,5484,1163,4251,181,47,0.212071480671043,0.775164113785558,3088,-0.563092633114515
TN,Weakley County,47183,2770,9001,12127,0.22841593139276,0.742228086088893,6231,-0.513812154696133,47183,12332,3547,8601,183,47,0.287625689263704,0.697453778786896,5054,-0.409828089523192
TN,White County,47185,1842,7657,9776,0.18842062193126,0.783244680851064,5815,-0.594824058919804,47185,9133,2793,6192,185,47,0.305814080805869,0.677980948209789,3399,-0.37216686740392
TN,Williamson County,47187,30992,68160,104700,0.296007640878701,0.651002865329513,37168,-0.354995224450812,47187,93606,24328,68090,187,47,0.259897869794671,0.727410636070337,43762,-0.467512766275666
TN,Wilson County,47189,14356,39304,56286,0.255054542870341,0.698290871619941,24948,-0.4432363287496,47189,51437,14669,36076,189,47,0.285183817096642,0.7013628322025,21407,-0.416179015105858
TX,Anderson County,48001,3358,13165,16887,0.198851187303843,0.779593770355895,9807,-0.580742583052052,48001,16167,3796,12235,1,48,0.234799282489021,0.756788519824333,8439,-0.521989237335313
TX,Andrews County,48003,836,3925,4926,0.16971173365814,0.796792529435648,3089,-0.627080795777507,48003,4476,794,3636,3,48,0.177390527256479,0.812332439678284,2842,-0.634941912421805
TX,Angelina County,48005,7538,21666,29870,0.252360227653164,0.725343153665886,14128,-0.472982926012722,48005,28403,7833,20301,5,48,0.275780727387952,0.714748442065979,12468,-0.438967714678027
TX,Aransas County,48007,2458,7730,10467,0.234833285564154,0.738511512372217,5272,-0.503678226808064,48007,9646,2703,6829,7,48,0.28021978021978,0.707961849471283,4126,-0.427742069251503
TX,Archer County,48009,394,3785,4269,0.092293277114078,0.886624502225346,3391,-0.794331225111267,48009,4163,525,3599,9,48,0.126110977660341,0.864520778284891,3074,-0.73840980062455
TX,Armstrong County,48011,70,924,1017,0.068829891838741,0.908554572271386,854,-0.839724680432645,48011,935,98,828,11,48,0.104812834224599,0.885561497326203,730,-0.780748663101604
TX,Atascosa County,48013,4635,8598,13605,0.340683572216097,0.631973539140022,3963,-0.291289966923925,48013,12704,5128,7451,13,48,0.403652392947103,0.586508186397985,2323,-0.182855793450882
TX,Austin County,48015,2319,9637,12255,0.189228886168911,0.786372909016728,7318,-0.597144022847817,48015,11628,2252,9260,15,48,0.193670450636395,0.796353629170967,7008,-0.602683178534572
TX,Bailey County,48017,397,1343,1784,0.222533632286996,0.75280269058296,946,-0.530269058295964,48017,1813,466,1336,17,48,0.257032542746829,0.736900165471594,870,-0.479867622724766
TX,Bandera County,48019,1726,8159,10213,0.169000293743268,0.798883775580143,6433,-0.629883481836875,48019,9434,1859,7423,19,48,0.197053211787153,0.786834852660589,5564,-0.589781640873437
TX,Bastrop County,48021,10555,16314,28250,0.373628318584071,0.577486725663717,5759,-0.203858407079646,48021,24457,9860,14019,21,48,0.403156560493928,0.573210123890911,4159,-0.170053563396982
TX,Baylor County,48023,191,1267,1492,0.128016085790885,0.849195710455764,1076,-0.721179624664879,48023,1592,267,1297,23,48,0.167713567839196,0.814698492462311,1030,-0.646984924623115
TX,Bee County,48025,3443,4743,8458,0.407070229368645,0.560770867817451,1300,-0.153700638448806,48025,7873,3451,4354,25,48,0.438333545027309,0.553029340784961,903,-0.114695795757653
TX,Bell County,48027,37608,51780,93999,0.400089362652794,0.55085692400983,14172,-0.150767561357036,48027,85765,35315,49369,27,48,0.411764705882353,0.57563108494141,14054,-0.163866379059057
TX,Bexar County,48029,319191,240161,586038,0.544659220050577,0.409804483668295,79030,0.134854736382282,48029,511405,263871,240519,29,48,0.515972663544549,0.470310223795231,23352,0.045662439749318
TX,Blanco County,48031,1244,4212,5669,0.219439054506968,0.742988181337096,2968,-0.523549126830129,48031,4971,1220,3637,31,48,0.245423456045061,0.731643532488433,2417,-0.486220076443372
TX,Borden County,48033,31,330,365,0.084931506849315,0.904109589041096,299,-0.819178082191781,48033,362,32,324,33,48,0.088397790055249,0.895027624309392,292,-0.806629834254144
TX,Bosque County,48035,1277,6325,7797,0.163780941387713,0.811209439528024,5048,-0.64742849814031,48035,7336,1366,5873,35,48,0.186205016357688,0.800572519083969,4507,-0.614367502726281
TX,Bowie County,48037,8831,24913,34470,0.25619379170293,0.72274441543371,16082,-0.46655062373078,48037,35357,10184,24840,37,48,0.288033487003988,0.702548293124417,14656,-0.414514806120429
TX,Brazoria County,48039,43075,72653,120296,0.358075081465718,0.603951918600785,29578,-0.245876837135067,48039,106422,34327,70684,39,48,0.322555486647498,0.664185976583789,36357,-0.341630489936291
TX,Brazos County,48041,23041,38662,66036,0.3489157429281,0.585468532315707,15621,-0.236552789387607,48041,55845,17440,37152,41,48,0.312292953711165,0.665269943593876,19712,-0.352976989882711
TX,Brewster County,48043,1869,2073,4226,0.442262186464742,0.490534784666351,204,-0.048272598201609,48043,3866,1765,1975,43,48,0.456544231764097,0.510863942058976,210,-0.054319710294879
TX,Briscoe County,48045,91,625,734,0.123978201634877,0.85149863760218,534,-0.727520435967302,48045,700,117,576,45,48,0.167142857142857,0.822857142857143,459,-0.655714285714286
TX,Brooks County,48047,1937,613,2596,0.746147919876733,0.23613251155624,1324,0.510015408320493,48047,2403,1886,507,47,48,0.784852267998335,0.210986267166042,1379,0.573866000832293
TX,Brown County,48049,1621,12010,13949,0.11620904724353,0.860993619614309,10389,-0.744784572370779,48049,13936,1904,11894,49,48,0.13662456946039,0.853473019517796,9990,-0.716848450057405
TX,Burleson County,48051,1491,5316,6945,0.214686825053996,0.765442764578834,3825,-0.550755939524838,48051,6455,1705,4671,51,48,0.264136328427575,0.723625096824167,2966,-0.459488768396592
TX,Burnet County,48053,3785,14595,19046,0.19872939199832,0.766302635724037,10810,-0.567573243725717,48053,16770,3672,12828,53,48,0.218962432915921,0.764937388193202,9156,-0.545974955277281
TX,Caldwell County,48055,4663,6516,11709,0.398240669570416,0.556495003843197,1853,-0.158254334272782,48055,11055,4787,6018,55,48,0.433016734509272,0.544369063772049,1231,-0.111352329262777
TX,Calhoun County,48057,2118,4638,6957,0.304441569642087,0.666666666666667,2520,-0.362225097024579,48057,6746,2510,4145,57,48,0.372072339163949,0.614438185591462,1635,-0.242365846427513
TX,Callahan County,48059,568,4858,5556,0.102231821454284,0.874370050395968,4290,-0.772138228941685,48059,5195,751,4376,59,48,0.14456207892204,0.842348411934552,3625,-0.697786333012512
TX,Cameron County,48061,59319,29432,91804,0.646148315977517,0.320596052459588,29887,0.325552263517929,48061,74802,49159,24955,61,48,0.657188310472982,0.333614074489987,24204,0.323574235982995
TX,Camp County,48063,1260,3201,4542,0.277410832232497,0.704755614266843,1941,-0.427344782034346,48063,4332,1428,2878,63,48,0.329639889196676,0.664358264081256,1450,-0.33471837488458
TX,Carson County,48065,249,2617,2945,0.084550084889644,0.888624787775891,2368,-0.804074702886248,48065,2775,292,2450,65,48,0.105225225225225,0.882882882882883,2158,-0.777657657657658
TX,Cass County,48067,2250,9182,11606,0.193865242116147,0.791142512493538,6932,-0.597277270377391,48067,11764,2921,8747,67,48,0.24829989799388,0.743539612376743,5826,-0.495239714382863
TX,Castro County,48069,526,1413,1996,0.263527054108216,0.707915831663327,887,-0.44438877755511,48069,2119,630,1470,69,48,0.297310051911279,0.693723454459651,840,-0.396413402548372
TX,Chambers County,48071,2939,13278,16661,0.176399975991837,0.796950963327531,10339,-0.620550987335694,48071,14692,2780,11761,71,48,0.189218622379526,0.800503675469643,8981,-0.611285053090117
TX,Cherokee County,48073,3466,12896,16701,0.207532483084845,0.772169331177774,9430,-0.564636848092929,48073,16387,3935,12291,73,48,0.240129370842741,0.750045767986819,8356,-0.509916397144077
TX,Childress County,48075,253,1802,2084,0.121401151631478,0.86468330134357,1549,-0.743282149712092,48075,1996,320,1665,75,48,0.160320641282565,0.834168336673347,1345,-0.673847695390781
TX,Clay County,48077,536,4376,5011,0.10696467770904,0.873278786669327,3840,-0.766314108960287,48077,5056,740,4266,77,48,0.146360759493671,0.84375,3526,-0.697389240506329
TX,Cochran County,48079,190,679,901,0.210876803551609,0.753607103218646,489,-0.542730299667037,48079,916,256,648,79,48,0.279475982532751,0.707423580786026,392,-0.427947598253275
TX,Coke County,48081,140,1265,1423,0.098383696416023,0.888966971187632,1125,-0.790583274771609,48081,1406,179,1216,81,48,0.127311522048364,0.864864864864865,1037,-0.737553342816501
TX,Coleman County,48083,387,3177,3635,0.10646492434663,0.874002751031637,2790,-0.767537826685007,48083,3483,441,3007,83,48,0.126614987080103,0.863336204421476,2566,-0.736721217341372
TX,Collin County,48085,139837,200395,356545,0.392200143039448,0.562046866454445,60558,-0.169846723414997,48085,301101,100754,195933,85,48,0.334618616344682,0.650721850807536,95179,-0.316103234462855
TX,Collingsworth County,48087,145,983,1154,0.125649913344887,0.851819757365685,838,-0.726169844020797,48087,1150,177,962,87,48,0.153913043478261,0.836521739130435,785,-0.682608695652174
TX,Colorado County,48089,1977,6323,8480,0.23313679245283,0.74563679245283,4346,-0.5125,48089,8095,2024,6015,89,48,0.250030883261272,0.743051266213712,3991,-0.49302038295244
TX,Comal County,48091,14166,44996,61567,0.230090795393636,0.730846070134975,30830,-0.500755274741339,48091,51475,11437,39291,91,48,0.222185526954832,0.76330257406508,27854,-0.541117047110248
TX,Comanche County,48093,788,4300,5208,0.151305683563748,0.825652841781874,3512,-0.674347158218126,48093,4897,890,3940,93,48,0.18174392485195,0.804574229119869,3050,-0.622830304267919
TX,Concho County,48095,148,885,1067,0.138706654170572,0.829428303655108,737,-0.690721649484536,48095,1001,194,793,95,48,0.193806193806194,0.792207792207792,599,-0.598401598401598
TX,Cooke County,48097,2345,13174,15894,0.147539952183214,0.828866238832264,10829,-0.68132628664905,48097,14291,2240,11901,97,48,0.156742005457981,0.832761878105101,9661,-0.676019872647121
TX,Coryell County,48099,5057,12212,18127,0.278976112980637,0.673691178904397,7155,-0.39471506592376,48099,16551,5141,11193,99,48,0.310615672769017,0.676273336958492,6052,-0.365657664189475
TX,Cottle County,48101,84,486,583,0.144082332761578,0.833619210977701,402,-0.689536878216124,48101,739,180,553,101,48,0.243572395128552,0.74830852503383,373,-0.504736129905277
TX,Crane County,48103,299,1047,1381,0.216509775524982,0.758146270818248,748,-0.541636495293266,48103,1283,275,985,103,48,0.214341387373344,0.767731878409977,710,-0.553390491036633
TX,Crockett County,48105,372,980,1395,0.266666666666667,0.702508960573477,608,-0.43584229390681,48105,1457,480,957,105,48,0.329444063143445,0.656829100892244,477,-0.327385037748799
TX,Crosby County,48107,468,1180,1712,0.273364485981308,0.689252336448598,712,-0.41588785046729,48107,1787,639,1132,107,48,0.357582540570789,0.633463905987689,493,-0.2758813654169
TX,Culberson County,48109,454,280,762,0.595800524934383,0.36745406824147,174,0.228346456692913,48109,876,566,294,109,48,0.646118721461187,0.335616438356164,272,0.310502283105023
TX,Dallam County,48111,222,1258,1535,0.144625407166124,0.819543973941368,1036,-0.674918566775244,48111,1532,253,1248,111,48,0.165143603133159,0.814621409921671,995,-0.649477806788512
TX,Dallas County,48113,458845,261865,750649,0.611264385884748,0.348851460536149,196980,0.262412925348598,48113,705941,403170,294339,113,48,0.571110050273323,0.416945608769005,108831,0.154164441504318
TX,Dawson County,48115,835,2636,3562,0.234418865805727,0.740033688938798,1801,-0.505614823133071,48115,3640,1017,2591,115,48,0.279395604395604,0.711813186813187,1574,-0.432417582417582
TX,Deaf Smith County,48117,1185,2911,4201,0.282075696262795,0.692930254701262,1726,-0.410854558438467,48117,4309,1239,3042,117,48,0.287537711766071,0.705964260849385,1803,-0.418426549083314
TX,Delta County,48119,400,1836,2279,0.175515577007459,0.805616498464239,1436,-0.630100921456779,48119,2018,454,1524,119,48,0.224975222993062,0.755203171456888,1070,-0.530227948463825
TX,Denton County,48121,110000,169175,293287,0.375059242312138,0.57682406652869,59175,-0.201764824216552,48121,240125,79917,156105,121,48,0.332814159292035,0.650098906819365,76188,-0.317284747527329
TX,DeWitt County,48123,1161,5510,6822,0.170184696569921,0.807681031955438,4349,-0.637496335385517,48123,6624,1463,5114,123,48,0.220863526570048,0.772041062801932,3651,-0.551177536231884
TX,Dickens County,48125,128,755,909,0.140814081408141,0.830583058305831,627,-0.68976897689769,48125,1019,216,793,125,48,0.211972522080471,0.778213935230618,577,-0.566241413150147
TX,Dimmit County,48127,2173,974,3225,0.673798449612403,0.302015503875969,1199,0.371782945736434,48127,2917,2141,762,127,48,0.733973260198834,0.261227288309907,1379,0.472745971888927
TX,Donley County,48129,190,1225,1460,0.13013698630137,0.839041095890411,1035,-0.708904109589041,48129,1533,226,1286,129,48,0.147423352902805,0.838878016960209,1060,-0.691454664057404
TX,Duval County,48131,2783,1316,4159,0.669151238278432,0.316422216879057,1467,0.352729021399375,48131,4343,3331,979,131,48,0.76698134929772,0.225420216440249,2352,0.541561132857472
TX,Eastland County,48133,776,6008,6935,0.111896178803172,0.866330209084355,5232,-0.754434030281182,48133,6494,970,5443,133,48,0.149368647982753,0.838158299969202,4473,-0.688789651986449
TX,Ector County,48135,10225,24976,36373,0.281115112858439,0.686663184230061,14751,-0.405548071371622,48135,32408,8095,23936,135,48,0.249784003949642,0.738583065909652,15841,-0.48879906196001
TX,Edwards County,48137,302,741,1065,0.283568075117371,0.695774647887324,439,-0.412206572769953,48137,883,232,641,137,48,0.262740656851642,0.725934314835787,409,-0.463193657984145
TX,Ellis County,48139,16197,44807,63064,0.256834327032855,0.710500443993404,28610,-0.453666116960548,48139,53756,13803,39353,139,48,0.256771337153062,0.732067118089143,25550,-0.475295780936081
TX,El Paso County,48141,145509,54567,210458,0.691392106738637,0.259277385511598,90942,0.432114721227038,48141,171053,112273,56517,141,48,0.656363817062548,0.330406365278598,55756,0.32595745178395
TX,Erath County,48143,2159,11205,13810,0.156335988414193,0.811368573497466,9046,-0.655032585083273,48143,12467,1965,10325,143,48,0.157616106521216,0.828186412128018,8360,-0.670570305606802
TX,Falls County,48145,1682,3438,5232,0.321483180428135,0.657110091743119,1756,-0.335626911314985,48145,5432,2033,3356,145,48,0.374263622974963,0.617820324005891,1323,-0.243556701030928
TX,Fannin County,48147,2123,9536,11972,0.177330437687939,0.796525225526228,7413,-0.619194787838289,48147,10781,2482,8143,147,48,0.230219831184491,0.755310268064187,5661,-0.525090436879696
TX,Fayette County,48149,2127,8648,11029,0.192855199927464,0.784114606945326,6521,-0.591259407017862,48149,10534,2311,8098,149,48,0.219384849060186,0.768748813366243,5787,-0.549363964306057
TX,Fisher County,48151,403,1265,1722,0.234030197444832,0.734610917537747,862,-0.500580720092915,48151,1628,512,1094,151,48,0.314496314496314,0.671990171990172,582,-0.357493857493857
TX,Floyd County,48153,435,1473,1958,0.222165474974464,0.752298263534219,1038,-0.530132788559755,48153,2085,551,1523,153,48,0.264268585131894,0.730455635491607,972,-0.466187050359712
TX,Foard County,48155,113,383,511,0.221135029354207,0.749510763209393,270,-0.528375733855186,48155,493,140,346,155,48,0.283975659229209,0.701825557809331,206,-0.417849898580122
TX,Fort Bend County,48157,134475,117212,260367,0.516482503543076,0.450179938317836,17263,0.06630256522524,48157,219250,101043,116028,157,48,0.460857468643102,0.529204104903079,14985,-0.068346636259977
TX,Franklin County,48159,665,3583,4356,0.152662993572084,0.822543617998163,2918,-0.669880624426079,48159,4255,750,3446,159,48,0.176263219741481,0.809870740305523,2696,-0.633607520564042
TX,Freestone County,48161,1461,5995,7608,0.192034700315457,0.787986330178759,4534,-0.595951629863302,48161,7562,1848,5644,161,48,0.244379793705369,0.746363395927003,3796,-0.501983602221634
TX,Frio County,48163,1401,1232,2683,0.522176667909057,0.459187476705181,169,0.062989191203876,48163,3968,2376,1559,163,48,0.598790322580645,0.39289314516129,817,0.205897177419355
TX,Gaines County,48165,597,3907,4609,0.129529182035149,0.847689303536559,3310,-0.71816012150141,48165,4066,535,3484,165,48,0.131578947368421,0.856861780619774,2949,-0.725282833251353
TX,Galveston County,48167,45503,73566,123994,0.366977434391987,0.593302901753311,28063,-0.226325467361324,48167,109227,39162,68594,167,48,0.358537724189074,0.627994909683503,29432,-0.269457185494429
TX,Garza County,48169,224,1223,1475,0.151864406779661,0.829152542372881,999,-0.67728813559322,48169,1556,276,1262,169,48,0.177377892030848,0.811053984575835,986,-0.633676092544987
TX,Gillespie County,48171,2286,10445,13123,0.174197973024461,0.795930808504153,8159,-0.621732835479692,48171,12535,2055,10305,171,48,0.163940965297168,0.822098125249302,8250,-0.658157159952134
TX,Glasscock County,48173,34,553,602,0.056478405315615,0.918604651162791,519,-0.862126245847176,48173,578,44,526,173,48,0.076124567474049,0.910034602076124,482,-0.833910034602076
TX,Goliad County,48175,973,2618,3713,0.262052248855373,0.705090223538917,1645,-0.443037974683544,48175,3452,1127,2294,175,48,0.326477404403244,0.664542294322132,1167,-0.338064889918888
TX,Gonzales County,48177,1567,4580,6304,0.248572335025381,0.726522842639594,3013,-0.477950507614213,48177,6039,1773,4213,177,48,0.293591654247392,0.697632058287796,2440,-0.404040404040404
TX,Gray County,48179,699,6495,7360,0.094972826086957,0.882472826086956,5796,-0.7875,48179,7373,885,6428,179,48,0.120032551200326,0.871829648718297,5543,-0.751797097517971
TX,Grayson County,48181,10276,35274,47068,0.21832242712671,0.749426361859437,24998,-0.531103934732727,48181,42207,10665,30907,181,48,0.252683204207833,0.732271898026394,20242,-0.479588693818561
TX,Gregg County,48183,11623,28693,41365,0.280986341109634,0.693654055360812,17070,-0.412667714251178,48183,41356,12336,28665,183,48,0.298288035593384,0.693127962085308,16329,-0.394839926491924
TX,Grimes County,48185,2194,7065,9528,0.230268681780017,0.741498740554156,4871,-0.511230058774139,48185,8598,2339,6141,185,48,0.272040009304489,0.714235868806699,3802,-0.44219585950221
TX,Guadalupe County,48187,18308,36495,57220,0.319958056623558,0.637801468018176,18187,-0.317843411394617,48187,49247,15654,32959,187,48,0.317867078197657,0.669259041159868,17305,-0.351391962962211
TX,Hale County,48189,2090,6347,8802,0.237446034992047,0.721086116791638,4257,-0.483640081799591,48189,8765,2228,6417,189,48,0.254192812321734,0.732116371933828,4189,-0.477923559612094
TX,Hall County,48191,164,891,1089,0.150596877869605,0.818181818181818,727,-0.667584940312213,48191,1108,265,832,191,48,0.239169675090253,0.750902527075812,567,-0.511732851985559
TX,Hamilton County,48193,479,3056,3609,0.13272374619008,0.84677195899141,2577,-0.71404821280133,48193,3551,591,2918,193,48,0.166431990988454,0.821740354829625,2327,-0.655308363841171
TX,Hansford County,48195,171,1730,1947,0.087827426810478,0.888546481766821,1559,-0.800719054956343,48195,1960,158,1787,195,48,0.080612244897959,0.911734693877551,1629,-0.831122448979592
TX,Hardeman County,48197,249,1207,1511,0.164791528788882,0.798808735936466,958,-0.634017207147585,48197,1495,302,1176,197,48,0.202006688963211,0.786622073578595,874,-0.584615384615385
TX,Hardin County,48199,2779,19600,22768,0.122057273366128,0.860857343640197,16821,-0.738800070274069,48199,21293,3358,17744,199,48,0.157704409899967,0.833325506034847,14386,-0.67562109613488
TX,Harris County,48201,706471,544960,1302887,0.542235051850237,0.418271116374636,161511,0.123963935475602,48201,1185478,585451,584866,201,48,0.493852268873821,0.493358797042206,585,0.000493471831616
TX,Harrison County,48203,7130,18712,26364,0.270444545592475,0.709755727507207,11582,-0.439311181914732,48203,26099,8431,17471,203,48,0.323039196904096,0.669412621173225,9040,-0.346373424269129
TX,Hartley County,48205,172,1727,1945,0.088431876606684,0.887917737789203,1555,-0.799485861182519,48205,1904,183,1700,205,48,0.096113445378151,0.892857142857143,1517,-0.796743697478992
TX,Haskell County,48207,314,1403,1765,0.177903682719547,0.794900849858357,1089,-0.61699716713881,48207,2006,551,1422,207,48,0.274675972083749,0.708873379860419,871,-0.43419740777667
TX,Hays County,48209,33117,33730,71524,0.463019406073486,0.471589955819026,613,-0.00857054974554,48209,58808,25448,31577,209,48,0.432730240783567,0.53695075499932,6129,-0.104220514215753
TX,Hemphill County,48211,181,1460,1687,0.107291049199763,0.865441612329579,1279,-0.758150563129816,48211,1509,192,1298,211,48,0.127236580516899,0.860172299536117,1106,-0.732935719019218
TX,Henderson County,48213,5649,23574,29855,0.189214536928488,0.78961647965165,17925,-0.600401942723162,48213,27582,6094,21202,213,48,0.220941193532014,0.76868972518309,15108,-0.547748531651077
TX,Hidalgo County,48215,118739,48608,172990,0.686392277010232,0.280987340308688,70131,0.405404936701543,48215,138966,97879,39786,215,48,0.704337751680267,0.286300246103363,58093,0.418037505576904
TX,Hill County,48217,2535,10075,12906,0.196420269642027,0.780644661397799,7540,-0.584224391755772,48217,12032,2745,9128,217,48,0.228141622340426,0.758643617021277,6383,-0.530501994680851
TX,Hockley County,48219,1257,5793,7282,0.172617412798682,0.795523207909915,4536,-0.622905795111233,48219,7119,1482,5543,219,48,0.208175305520438,0.778620592779885,4061,-0.570445287259447
TX,Hood County,48221,4001,21367,26120,0.153177641653905,0.818032159264931,17366,-0.664854517611026,48221,22445,3829,18341,221,48,0.170594787257741,0.817153040766318,14512,-0.646558253508577
TX,Hopkins County,48223,2508,10704,13476,0.186108637577916,0.794300979519145,8196,-0.608192341941229,48223,12742,2775,9834,223,48,0.217783707424266,0.771778370742427,7059,-0.55399466331816
TX,Houston County,48225,1978,6205,8302,0.238255841965791,0.747410262587328,4227,-0.509154420621537,48225,8129,2235,5839,225,48,0.274941567228441,0.718292532906877,3604,-0.443350965678435
TX,Howard County,48227,1768,6635,8692,0.203405430280718,0.763345605154165,4867,-0.559940174873447,48227,5139,1042,4032,227,48,0.202763183498735,0.784588441330998,2990,-0.581825257832263
TX,Hudspeth County,48229,324,503,871,0.371986222732491,0.577497129735936,179,-0.205510907003444,48229,861,379,471,229,48,0.440185830429733,0.547038327526132,92,-0.106852497096399
TX,Hunt County,48231,6301,23866,31185,0.202052268718935,0.765303831970499,17565,-0.563251563251563,48231,27984,6658,20976,231,48,0.237921669525443,0.749571183533448,14318,-0.511649514008005
TX,Hutchinson County,48233,854,7039,8126,0.105094757568299,0.866231848387891,6185,-0.761137090819591,48233,7916,1042,6797,233,48,0.131632137443153,0.858640727640222,5755,-0.727008590197069
TX,Irion County,48235,90,660,760,0.118421052631579,0.868421052631579,570,-0.75,48235,788,112,668,235,48,0.142131979695431,0.847715736040609,556,-0.705583756345178
TX,Jack County,48237,314,2973,3339,0.094040131775981,0.890386343216532,2659,-0.796346211440551,48237,2907,303,2580,237,48,0.104231166150671,0.887512899896801,2277,-0.78328173374613
TX,Jackson County,48239,904,4266,5275,0.171374407582938,0.808720379146919,3362,-0.637345971563981,48239,5018,1068,3903,239,48,0.212833798326026,0.777799920286967,2835,-0.564966121960941
TX,Jasper County,48241,2582,10578,13351,0.193393753276908,0.792300202232043,7996,-0.598906448955134,48241,13466,3402,9924,241,48,0.252636269122234,0.736967176592901,6522,-0.484330907470667
TX,Jeff Davis County,48243,422,694,1175,0.359148936170213,0.59063829787234,272,-0.231489361702128,48243,1188,440,717,243,48,0.37037037037037,0.603535353535353,277,-0.233164983164983
TX,Jefferson County,48245,42404,42828,87363,0.485377104723968,0.490230417911473,424,-0.004853313187505,48245,88548,44626,43214,245,48,0.503975245064824,0.488029091566156,1412,0.015946153498667
TX,Jim Hogg County,48247,1635,430,2119,0.771590372817367,0.202925908447381,1205,0.568664464369986,48247,1667,1301,356,247,48,0.780443911217756,0.213557288542292,945,0.566886622675465
TX,Jim Wells County,48249,6688,5411,12346,0.541713915438199,0.438279604730277,1277,0.103434310707922,48249,11163,6492,4595,249,48,0.581564095673206,0.411627698647317,1897,0.169936397025889
TX,Johnson County,48251,10976,44370,57270,0.191653570804959,0.774751178627554,33394,-0.583097607822595,48251,48753,10481,37609,251,48,0.214981642155355,0.771419194716223,27128,-0.556437552560868
TX,Jones County,48253,935,4815,5932,0.157619689817937,0.811699258260283,3880,-0.654079568442347,48253,5562,1225,4258,253,48,0.220244516361021,0.765551959726717,3033,-0.545307443365696
TX,Karnes County,48255,1144,2959,4185,0.273357228195938,0.707048984468339,1815,-0.433691756272401,48255,4180,1324,2823,255,48,0.316746411483254,0.675358851674641,1499,-0.358612440191388
TX,Kaufman County,48257,10265,29537,40979,0.250494155543083,0.72078381610093,19272,-0.470289660557847,48257,34604,9451,24804,257,48,0.273118714599468,0.716795746156514,15353,-0.443677031557045
TX,Kendall County,48259,3633,15663,19936,0.182233146067416,0.785664125200642,12030,-0.603430979133226,48259,17729,3035,14467,259,48,0.171188448305037,0.816007671047436,11432,-0.644819222742399
TX,Kenedy County,48261,99,84,186,0.532258064516129,0.451612903225806,15,0.080645161290323,48261,166,82,83,261,48,0.493975903614458,0.5,1,-0.006024096385542
TX,Kent County,48263,59,360,433,0.136258660508083,0.831408775981524,301,-0.695150115473441,48263,404,66,334,263,48,0.163366336633663,0.826732673267327,268,-0.663366336633663
TX,Kerr County,48265,4665,17658,23090,0.202035513209181,0.764746643568644,12993,-0.562711130359463,48265,21811,4325,17225,265,48,0.198294438586035,0.789739122461143,12900,-0.591444683875109
TX,Kimble County,48267,206,1697,1945,0.105912596401028,0.872493573264782,1491,-0.766580976863753,48267,1891,217,1667,267,48,0.114754098360656,0.881544156530936,1450,-0.76679005817028
TX,King County,48269,5,149,159,0.031446540880503,0.937106918238994,144,-0.905660377358491,48269,145,5,139,269,48,0.03448275862069,0.958620689655172,134,-0.924137931034483
TX,Kinney County,48271,457,936,1424,0.320926966292135,0.657303370786517,479,-0.336376404494382,48271,1425,522,880,271,48,0.366315789473684,0.617543859649123,358,-0.251228070175439
TX,Kleberg County,48273,4713,4364,9483,0.496994621955077,0.46019192238743,349,0.036802699567647,48273,8902,4752,4056,273,48,0.533812626376095,0.455627948775556,696,0.078184677600539
TX,Knox County,48275,247,1078,1358,0.181885125184094,0.793814432989691,831,-0.611929307805596,48275,1510,332,1160,275,48,0.219867549668874,0.768211920529801,828,-0.548344370860927
TX,Lamar County,48277,3579,14546,18537,0.193073312833792,0.784700868533204,10967,-0.591627555699412,48277,17173,4173,12814,277,48,0.242997728993187,0.746171315437023,8641,-0.503173586443836
TX,Lamb County,48279,770,3040,3905,0.197183098591549,0.778489116517286,2270,-0.581306017925736,48279,4089,998,3056,279,48,0.244069454634385,0.747370995353387,2058,-0.503301540719002
TX,Lampasas County,48281,1479,6371,8149,0.181494661921708,0.781813719474782,4892,-0.600319057553074,48281,7138,1457,5583,281,48,0.204118800784533,0.782151863267022,4126,-0.578033062482488
TX,La Salle County,48283,1125,870,2049,0.54904831625183,0.424597364568082,255,0.124450951683748,48283,1646,965,669,283,48,0.586269744835966,0.406439854191981,296,0.179829890643985
TX,Lavaca County,48285,1170,7339,8633,0.135526468203406,0.850110042858798,6169,-0.714583574655392,48285,8279,1427,6788,285,48,0.172363812054596,0.819905785722913,5361,-0.647541973668317
TX,Lee County,48287,1372,4996,6522,0.210364918736584,0.766022692425636,3624,-0.555657773689052,48287,6211,1630,4504,287,48,0.26243761069071,0.725165029785864,2874,-0.462727419095154
TX,Leon County,48289,909,6391,7407,0.122721749696233,0.862832455785068,5482,-0.740110706088835,48289,6941,1061,5812,289,48,0.152859818469961,0.837343322287855,4751,-0.684483503817894
TX,Liberty County,48291,4851,18856,24155,0.200827985924239,0.780625129372801,14005,-0.579797143448561,48291,22711,5196,17304,291,48,0.228787812073445,0.761921535819647,12108,-0.533133723746202
TX,Limestone County,48293,1748,5747,7648,0.228556485355649,0.751438284518828,3999,-0.52288179916318,48293,7563,2208,5288,293,48,0.291947639825466,0.699193441755917,3080,-0.407245801930451
TX,Lipscomb County,48295,135,1159,1322,0.102118003025719,0.876701966717095,1024,-0.774583963691377,48295,1168,119,1044,295,48,0.101883561643836,0.893835616438356,925,-0.791952054794521
TX,Live Oak County,48297,739,3450,4267,0.173189594562925,0.80853058354816,2711,-0.635340988985235,48297,4108,915,3153,297,48,0.222736124634859,0.767526777020448,2238,-0.544790652385589
TX,Llano County,48299,1825,8283,10377,0.175869711862773,0.798207574443481,6458,-0.622337862580707,48299,9502,1818,7560,299,48,0.191328141443907,0.795621974321196,5742,-0.604293832877289
TX,Loving County,48301,4,57,64,0.0625,0.890625,53,-0.828125,48301,64,9,54,301,48,0.140625,0.84375,45,-0.703125
TX,Lubbock County,48303,27956,65566,98060,0.285090760758719,0.668631450132572,37610,-0.383540689373853,48303,90615,26088,63133,303,48,0.287899354411521,0.696716879103901,37045,-0.40881752469238
TX,Lynn County,48305,403,1546,1997,0.201802704056084,0.774161241862794,1143,-0.57235853780671,48305,1852,464,1377,305,48,0.250539956803456,0.743520518358531,913,-0.492980561555076
TX,McCulloch County,48307,480,2546,3086,0.155541153596889,0.8250162022035,2066,-0.669475048606611,48307,2993,537,2419,307,48,0.179418643501504,0.808219178082192,1882,-0.628800534580688
TX,McLennan County,48309,27046,48245,78255,0.345613698805188,0.616510127148425,21199,-0.270896428343237,48309,74493,25688,47885,309,48,0.344837769991811,0.642812076302471,22197,-0.29797430631066
TX,McMullen County,48311,40,454,497,0.080482897384306,0.913480885311871,414,-0.832997987927565,48311,508,67,436,311,48,0.131889763779528,0.858267716535433,369,-0.726377952755906
TX,Madison County,48313,881,3349,4283,0.205696941396218,0.781928554751342,2468,-0.576231613355125,48313,4025,964,3028,313,48,0.239503105590062,0.752298136645963,2064,-0.512795031055901
TX,Marion County,48315,1156,2968,4206,0.274845458868283,0.7056585829767,1812,-0.430813124108416,48315,4271,1487,2730,315,48,0.348162022945446,0.639194568016858,1243,-0.291032545071412
TX,Martin County,48317,266,1453,1755,0.151566951566952,0.827920227920228,1187,-0.676353276353276,48317,1593,247,1338,317,48,0.155053358443189,0.839924670433145,1091,-0.684871311989956
TX,Mason County,48319,353,1656,2053,0.171943497320994,0.806624452021432,1303,-0.634680954700438,48319,1965,380,1562,319,48,0.193384223918575,0.794910941475827,1182,-0.601526717557252
TX,Matagorda County,48321,3357,8147,11779,0.284998726547245,0.69165463961287,4790,-0.406655913065625,48321,12110,3972,8026,321,48,0.327993393889348,0.662758051197358,4054,-0.33476465730801
TX,Maverick County,48323,10397,2816,13588,0.76516043567854,0.207241683838681,7581,0.557918751839859,48323,10562,8302,2171,323,48,0.7860253739822,0.205548191630373,6131,0.580477182351827
TX,Medina County,48325,4624,12054,17187,0.269040553907023,0.701344039099319,7430,-0.432303485192297,48325,15948,4760,11016,325,48,0.298470027589666,0.690744920993228,6256,-0.392274893403562
TX,Menard County,48327,153,681,860,0.177906976744186,0.791860465116279,528,-0.613953488372093,48327,846,170,663,327,48,0.200945626477541,0.783687943262411,493,-0.58274231678487
TX,Midland County,48329,9993,36896,48753,0.204972001722971,0.756794453674646,26903,-0.551822451951675,48329,44277,8223,35452,329,48,0.185717189511485,0.80068658671545,27229,-0.614969397203966
TX,Milam County,48331,2042,6340,8607,0.237248751016614,0.736609736261183,4298,-0.499360985244568,48331,8220,2632,5478,331,48,0.320194647201946,0.666423357664234,2846,-0.346228710462287
TX,Mills County,48333,242,1949,2238,0.108132260947274,0.870866845397676,1707,-0.762734584450402,48333,2197,279,1882,333,48,0.126991351843423,0.856622667273555,1603,-0.729631315430132
TX,Mitchell County,48335,353,1780,2190,0.161187214611872,0.812785388127854,1427,-0.651598173515982,48335,2312,536,1754,335,48,0.231833910034602,0.758650519031142,1218,-0.52681660899654
TX,Montague County,48337,885,7526,8604,0.102859135285914,0.874709437470944,6641,-0.77185030218503,48337,7737,1116,6539,337,48,0.144241954245832,0.845159622592736,5423,-0.700917668346905
TX,Montgomery County,48339,45744,150188,203083,0.225247805084621,0.739539991038147,104444,-0.514292185953526,48339,172820,32852,137822,339,48,0.190093739150561,0.797488716583729,104970,-0.607394977433168
TX,Moore County,48341,1096,3974,5262,0.208285822881034,0.755226149752946,2878,-0.546940326871912,48341,4983,963,3967,341,48,0.193257074051776,0.79610676299418,3004,-0.602849688942404
TX,Morris County,48343,1425,3443,4964,0.287066881547139,0.693593875906527,2018,-0.406526994359388,48343,5129,1856,3226,343,48,0.36186391109378,0.628972509261065,1370,-0.267108598167284
TX,Motley County,48345,40,571,620,0.064516129032258,0.920967741935484,531,-0.856451612903226,48345,599,55,538,345,48,0.091819699499165,0.898163606010017,483,-0.806343906510851
TX,Nacogdoches County,48347,6822,14751,22430,0.30414623272403,0.657646009808292,7929,-0.353499777084262,48347,20601,6441,13910,347,48,0.312654725498762,0.675209941264987,7469,-0.362555215766225
TX,Navarro County,48349,3998,11984,16382,0.24404834574533,0.731534611158589,7986,-0.487486265413258,48349,15316,4348,10838,349,48,0.283886132149386,0.707626012013581,6490,-0.423739879864194
TX,Newton County,48351,978,2961,4010,0.243890274314214,0.738403990024938,1983,-0.494513715710723,48351,6188,1721,4399,351,48,0.278118939883646,0.710892049127343,2678,-0.432773109243697
TX,Nolan County,48353,1029,3551,4744,0.216905564924115,0.748524451939292,2522,-0.531618887015177,48353,4567,1216,3277,353,48,0.266257937376834,0.717538865776221,2061,-0.451280928399387
TX,Nueces County,48355,49102,50704,103958,0.47232536216549,0.487735431616614,1602,-0.015410069451125,48355,95781,45666,48779,355,48,0.476775143295643,0.509276370052516,3113,-0.032501226756872
TX,Ochiltree County,48357,274,2628,2981,0.091915464609192,0.881583361288158,2354,-0.789667896678967,48357,2990,253,2718,357,48,0.084615384615385,0.909030100334448,2465,-0.824414715719064
TX,Oldham County,48359,78,850,945,0.082539682539683,0.899470899470899,772,-0.816931216931217,48359,865,71,786,359,48,0.082080924855491,0.908670520231214,715,-0.826589595375723
TX,Orange County,48361,5716,25385,31761,0.179969144548345,0.799250653316961,19669,-0.619281508768616,48361,30502,6797,23361,361,48,0.222837846698577,0.765884204314471,16564,-0.543046357615894
TX,Palo Pinto County,48363,1700,8222,10175,0.167076167076167,0.808058968058968,6522,-0.640982800982801,48363,9335,1810,7392,363,48,0.193893947509373,0.791858596679164,5582,-0.597964649169791
TX,Panola County,48365,1835,8445,10413,0.176222030154614,0.811005473926822,6610,-0.634783443772208,48365,10221,2211,7941,365,48,0.216319342530085,0.776929850308189,5730,-0.560610507778104
TX,Parker County,48367,8329,46433,56413,0.147643273713506,0.823090422420364,38104,-0.675447148706858,48367,47346,7804,38980,367,48,0.164829130232755,0.823300806826342,31176,-0.658471676593588
TX,Parmer County,48369,848,1911,2818,0.300922640170334,0.678140525195174,1063,-0.37721788502484,48369,2545,528,2005,369,48,0.207465618860511,0.787819253438114,1477,-0.580353634577603
TX,Pecos County,48371,1551,2463,4167,0.372210223182145,0.591072714182865,912,-0.21886249100072,48371,4147,1591,2512,371,48,0.383650831926694,0.605739088497709,921,-0.222088256571015
TX,Polk County,48373,7123,26587,34444,0.206799442573453,0.771890605040065,19464,-0.565091162466612,48373,19058,4836,14019,373,48,0.2537517053206,0.73559659985308,9183,-0.48184489453248
TX,Potter County,48375,7620,19499,28330,0.268972820331804,0.688280974232262,11879,-0.419308153900459,48375,26418,7114,18905,375,48,0.269286092815505,0.715610568551745,11791,-0.44632447573624
TX,Presidio County,48377,1458,652,2203,0.661824784384929,0.295960054471176,806,0.365864729913754,48377,1808,1273,504,377,48,0.704092920353982,0.278761061946903,769,0.42533185840708
TX,Rains County,48379,619,3919,4630,0.133693304535637,0.846436285097192,3300,-0.712742980561555,48379,4065,754,3265,379,48,0.185485854858549,0.80319803198032,2511,-0.617712177121771
TX,Randall County,48381,8340,43379,53813,0.154981138386635,0.806106331183915,35039,-0.651125192797279,48381,49588,7553,41366,381,48,0.15231507622812,0.834193756554005,33813,-0.681878680325885
TX,Reagan County,48383,167,709,900,0.185555555555556,0.787777777777778,542,-0.602222222222222,48383,843,158,676,383,48,0.187425860023725,0.801897983392645,518,-0.614472123368921
TX,Real County,48385,262,1382,1678,0.156138259833135,0.823599523241955,1120,-0.66746126340882,48385,1533,277,1236,385,48,0.180691454664057,0.806262230919765,959,-0.625570776255708
TX,Red River County,48387,1148,3924,5147,0.223042549057704,0.762385855838352,2776,-0.539343306780649,48387,5074,1482,3549,387,48,0.292077256602286,0.699448167126527,2067,-0.407370910524241
TX,Reeves County,48389,1659,1417,3184,0.521042713567839,0.445037688442211,242,0.076005025125628,48389,2867,1649,1185,389,48,0.575165678409487,0.413324032089292,464,0.161841646320195
TX,Refugio County,48391,1034,1830,2945,0.351103565365025,0.621392190152801,796,-0.270288624787776,48391,2673,998,1659,391,48,0.373363262252151,0.620650953984287,661,-0.247287691732136
TX,Roberts County,48393,20,524,550,0.036363636363636,0.952727272727273,504,-0.916363636363636,48393,439,25,408,393,48,0.056947608200456,0.929384965831435,383,-0.872437357630979
TX,Robertson County,48395,2203,4665,7010,0.314265335235378,0.665477888730385,2462,-0.351212553495007,48395,7278,2792,4416,395,48,0.383621874141248,0.606760098928277,1624,-0.223138224787029
TX,Rockwall County,48397,9633,28396,39529,0.243694502770118,0.718358673379038,18763,-0.47466417060892,48397,35651,8112,27098,397,48,0.227539199461446,0.760090881041205,18986,-0.532551681579759
TX,Runnels County,48399,452,3241,3765,0.120053120849934,0.860823373173971,2789,-0.740770252324037,48399,3665,517,3103,399,48,0.14106412005457,0.846657571623465,2586,-0.705593451568895
TX,Rusk County,48401,3935,14675,18994,0.207170685479625,0.772612403917026,10740,-0.565441718437401,48401,18537,4451,13924,401,48,0.240114365862869,0.751146355936775,9473,-0.511031990073906
TX,Sabine County,48403,614,3992,4642,0.132270573028867,0.859974149073675,3378,-0.727703576044808,48403,4572,806,3726,403,48,0.176290463692039,0.81496062992126,2920,-0.638670166229221
TX,San Augustine County,48405,907,2620,3563,0.254560763401628,0.735335391523997,1713,-0.480774628122369,48405,3690,1193,2469,405,48,0.323306233062331,0.669105691056911,1276,-0.34579945799458
TX,San Jacinto County,48407,2034,8050,10305,0.197379912663755,0.781174187287724,6016,-0.583794274623969,48407,9610,2410,7105,407,48,0.250780437044745,0.739334027055151,4695,-0.488553590010406
TX,San Patricio County,48409,7825,13004,21513,0.363733556454237,0.604471714777112,5179,-0.240738158322874,48409,20064,7854,11994,409,48,0.391447368421053,0.597787081339713,4140,-0.20633971291866
TX,San Saba County,48411,293,2025,2354,0.12446898895497,0.860237892948173,1732,-0.735768903993203,48411,2256,323,1905,411,48,0.143173758865248,0.844414893617021,1582,-0.701241134751773
TX,Schleicher County,48413,209,819,1054,0.198292220113852,0.777039848197343,610,-0.578747628083492,48413,1010,220,781,413,48,0.217821782178218,0.773267326732673,561,-0.555445544554456
TX,Scurry County,48415,733,4403,5261,0.13932712412089,0.836913134385098,3670,-0.697586010264208,48415,5022,837,4121,415,48,0.166666666666667,0.820589406610912,3284,-0.653922739944245
TX,Shackelford County,48417,103,1378,1502,0.068575233022637,0.917443408788282,1275,-0.848868175765646,48417,1363,131,1218,417,48,0.096111518708731,0.893617021276596,1087,-0.797505502567865
TX,Shelby County,48419,1757,7171,9072,0.193672839506173,0.790454144620811,5414,-0.596781305114638,48419,9261,2318,6870,419,48,0.250296944174495,0.741820537738905,4552,-0.49152359356441
TX,Sherman County,48421,96,807,933,0.102893890675241,0.864951768488746,711,-0.762057877813505,48421,1038,121,908,421,48,0.116570327552987,0.8747591522158,787,-0.758188824662813
TX,Smith County,48423,22128,58631,83161,0.266086266398913,0.705030002044227,36503,-0.438943735645314,48423,84794,22101,61858,423,48,0.260643441752954,0.729509163384202,39757,-0.468865721631248
TX,Somervell County,48425,540,3206,3876,0.139318885448916,0.827141382868937,2666,-0.687822497420021,48425,3507,609,2858,425,48,0.173652694610778,0.814941545480468,2249,-0.641288850869689
TX,Starr County,48427,9246,2218,11691,0.79086476777008,0.189718586947224,7028,0.601146180822855,48427,11859,10248,1540,427,48,0.864153807235011,0.129859178682857,8708,0.734294628552154
TX,Stephens County,48429,348,3033,3453,0.100781928757602,0.878366637706342,2685,-0.77758470894874,48429,3407,475,2891,429,48,0.139418843557382,0.848547108893455,2416,-0.709128265336073
TX,Sterling County,48431,70,549,633,0.110584518167457,0.867298578199052,479,-0.756714060031596,48431,494,31,459,431,48,0.062753036437247,0.92914979757085,428,-0.866396761133603
TX,Stonewall County,48433,135,555,701,0.192582025677603,0.791726105563481,420,-0.599144079885877,48433,675,160,507,433,48,0.237037037037037,0.751111111111111,347,-0.514074074074074
TX,Sutton County,48435,313,1075,1415,0.221201413427562,0.759717314487632,762,-0.538515901060071,48435,1489,369,1110,435,48,0.247817327065144,0.745466756212223,741,-0.497649429147079
TX,Swisher County,48437,462,1671,2190,0.210958904109589,0.763013698630137,1209,-0.552054794520548,48437,2265,579,1654,437,48,0.255629139072848,0.730242825607064,1075,-0.474613686534216
TX,Tarrant County,48439,288001,345683,662832,0.434500748304246,0.521524307818572,57682,-0.087023559514326,48439,610149,252789,348686,439,48,0.414306997143321,0.571476803207086,95897,-0.157169806063765
TX,Taylor County,48441,10047,33172,45266,0.221954667962709,0.732823752927142,23125,-0.510869084964432,48441,43170,9725,32853,441,48,0.225272179754459,0.761014593467686,23128,-0.535742413713227
TX,Terrell County,48443,140,287,437,0.320366132723112,0.65675057208238,147,-0.336384439359268,48443,553,184,358,443,48,0.332730560578662,0.647377938517179,174,-0.314647377938517
TX,Terry County,48445,424,1295,1763,0.240499149177538,0.734543391945547,871,-0.494044242768009,48445,3707,1059,2602,445,48,0.28567574858376,0.701915295387106,1543,-0.416239546803345
TX,Throckmorton County,48447,84,715,808,0.103960396039604,0.88490099009901,631,-0.780940594059406,48447,813,109,700,447,48,0.134071340713407,0.861008610086101,591,-0.726937269372694
TX,Titus County,48449,2538,6405,9176,0.276591107236268,0.698016564952049,3867,-0.42142545771578,48449,8790,2638,6062,449,48,0.300113765642776,0.689647326507395,3424,-0.389533560864619
TX,Tom Green County,48451,9117,27376,38104,0.239266218769683,0.718454755406257,18259,-0.479188536636574,48451,36527,9246,26749,451,48,0.253127823254031,0.732307608070742,17503,-0.479179784816711
TX,Travis County,48453,306475,126750,462511,0.662632888731295,0.274047536166707,179725,0.388585352564588,48453,384890,231540,139503,453,48,0.601574475824261,0.362449011405856,92037,0.239125464418405
TX,Trinity County,48455,1154,4737,5982,0.192912069541959,0.791875626880642,3583,-0.598963557338683,48455,6234,1614,4537,455,48,0.258902791145332,0.727783124799487,2923,-0.468880333654155
TX,Tyler County,48457,1243,6601,7969,0.155979420253482,0.828334797339691,5358,-0.672355377086209,48457,7623,1659,5889,457,48,0.21763085399449,0.772530499803227,4230,-0.554899645808737
TX,Upshur County,48459,2378,13198,15918,0.149390626963186,0.82912426184194,10820,-0.679733634878754,48459,15049,2953,11948,459,48,0.19622566283474,0.79393979666423,8995,-0.59771413382949
TX,Upton County,48461,284,961,1296,0.219135802469136,0.741512345679012,677,-0.522376543209877,48461,1298,332,952,461,48,0.2557781201849,0.733436055469954,620,-0.477657935285054
TX,Uvalde County,48463,3863,4828,8936,0.432296329453894,0.540286481647269,965,-0.107990152193375,48463,8431,3824,4526,463,48,0.453564227256553,0.536828371486182,702,-0.083264144229629
TX,Val Verde County,48465,6920,5856,13476,0.513505491243692,0.434550311665183,1064,0.07895517957851,48465,12040,6267,5612,465,48,0.520514950166113,0.466112956810631,655,0.054401993355482
TX,Van Zandt County,48467,2792,18436,21689,0.12872884872516,0.850016137212412,15644,-0.721287288487252,48467,19081,3083,15790,467,48,0.161574340967455,0.8275247628531,12707,-0.665950421885645
TX,Victoria County,48469,8843,21253,31032,0.284963908223769,0.684873678783192,12410,-0.399909770559422,48469,28827,8795,19684,469,48,0.305095917022236,0.68283206715926,10889,-0.377736150137024
TX,Walker County,48471,6085,12878,19683,0.309150027942895,0.654270182390896,6793,-0.345120154448001,48471,15066,5283,9569,471,48,0.350657108721625,0.635138722952343,4286,-0.284481614230718
TX,Waller County,48473,5744,10525,16715,0.34364343404128,0.629673945557882,4781,-0.286030511516602,48473,15699,6401,9158,473,48,0.407732976622715,0.583349257914517,2757,-0.175616281291802
TX,Ward County,48475,780,2541,3413,0.228537943158512,0.744506299443305,1761,-0.515968356284793,48475,3238,836,2364,475,48,0.258184064237183,0.730080296479308,1528,-0.471896232242125
TX,Washington County,48477,3381,10944,14747,0.229266969553129,0.742117040754052,7563,-0.512850071200922,48477,14373,3378,10850,477,48,0.235024003339595,0.754887636540736,7472,-0.519863633201141
TX,Webb County,48479,42297,12946,56867,0.74378813723249,0.227653999683472,29351,0.516134137549018,48479,49101,37592,11074,479,48,0.765605588480886,0.225535121484287,26518,0.540070466996599
TX,Wharton County,48481,4238,10149,14707,0.288162099680424,0.6900795539539,5911,-0.401917454273475,48481,14087,4235,9750,481,48,0.300631788173493,0.692127493433662,5515,-0.391495705260169
TX,Wheeler County,48483,194,2087,2306,0.084128360797919,0.905030355594102,1893,-0.820901994796184,48483,2128,232,1878,483,48,0.109022556390977,0.882518796992481,1646,-0.773496240601504
TX,Wichita County,48485,8752,27609,37913,0.230844301426951,0.72821987181178,18857,-0.497375570384828,48485,40923,10490,29756,485,48,0.256335068299001,0.727121667521931,19266,-0.470786599222931
TX,Wilbarger County,48487,807,3166,4101,0.196781272860278,0.772006827603024,2359,-0.575225554742746,48487,3980,971,2956,487,48,0.243969849246231,0.742713567839196,1985,-0.498743718592965
TX,Willacy County,48489,3416,1541,5082,0.672176308539945,0.303227075954349,1875,0.368949232585596,48489,5058,3595,1415,489,48,0.71075523922499,0.279754843811783,2180,0.431000395413207
TX,Williamson County,48491,84252,104029,200524,0.420159182940695,0.518785781253117,19777,-0.098626598312422,48491,162936,61812,96910,491,48,0.379363676535572,0.594773407963863,35098,-0.215409731428291
TX,Wilson County,48493,4790,13991,19255,0.248766554141781,0.726616463256297,9201,-0.477849909114516,48493,17186,4819,12205,493,48,0.280402653322472,0.710171069475154,7386,-0.429768416152682
TX,Winkler County,48495,420,1403,1873,0.224239188467699,0.749065670048051,983,-0.524826481580352,48495,1745,398,1331,495,48,0.228080229226361,0.762750716332378,933,-0.534670487106017
TX,Wise County,48497,3412,20655,24661,0.138356108835814,0.837557276671668,17243,-0.699201167835854,48497,20692,3219,17178,497,48,0.15556736903151,0.830175913396482,13959,-0.674608544364972
TX,Wood County,48499,2624,15681,18646,0.140727233723051,0.840984661589617,13057,-0.700257427866567,48499,17541,3052,14317,499,48,0.173992360754803,0.816202040932672,11265,-0.642209680177869
TX,Yoakum County,48501,426,1797,2299,0.185297955632884,0.781644193127447,1371,-0.596346237494563,48501,2128,409,1698,501,48,0.192199248120301,0.797932330827068,1289,-0.605733082706767
TX,Young County,48503,873,6587,7658,0.11399843301123,0.860146252285192,5714,-0.746147819273962,48503,7316,992,6225,503,48,0.135593220338983,0.850874794969929,5233,-0.715281574630946
TX,Zapata County,48505,2056,1028,3134,0.656030631780472,0.328015315890236,1028,0.328015315890236,48505,3529,2517,993,505,48,0.71323321054123,0.2813828279966,1524,0.43185038254463
TX,Zavala County,48507,2633,692,3390,0.77669616519174,0.204129793510324,1941,0.572566371681416,48507,3653,3042,574,507,48,0.832740213523132,0.157131125102655,2468,0.675609088420476
UT,Beaver County,49001,264,1838,2490,0.106024096385542,0.738152610441767,1574,-0.632128514056225,49001,2534,341,2153,1,49,0.134569850039463,0.849644830307814,1812,-0.71507498026835
UT,Box Elder County,49003,1814,10324,16548,0.109620497945371,0.623882040125695,8510,-0.514261542180324,49003,18092,1830,15969,3,49,0.101149679416317,0.882655317267301,14139,-0.781505637850984
UT,Cache County,49005,6705,16643,35879,0.186878118119234,0.46386465620558,9938,-0.276986538086346,49005,37099,5434,30818,5,49,0.14647295075339,0.830696245181811,25384,-0.684223294428421
UT,Carbon County,49007,1696,5182,7818,0.216935277564594,0.66282936812484,3486,-0.445894090560246,49007,7231,2204,4834,7,49,0.304798783017563,0.668510579449592,2630,-0.363711796432029
UT,Daggett County,49009,76,327,465,0.163440860215054,0.703225806451613,251,-0.539784946236559,49009,509,91,399,9,49,0.178781925343811,0.783889980353635,308,-0.605108055009823
UT,Davis County,49011,22575,46985,104661,0.215696391205893,0.448925578773373,24410,-0.23322918756748,49011,112568,20417,90030,11,49,0.181374813446095,0.799783242129202,69613,-0.618408428683107
UT,Duchesne County,49013,500,5505,6932,0.072129255626082,0.794143104443162,5005,-0.72201384881708,49013,6273,570,5608,13,49,0.090865614538498,0.893990116371752,5038,-0.803124501833254
UT,Emery County,49015,379,3402,4263,0.088904527328173,0.798029556650246,3023,-0.709125029322074,49015,4414,569,3743,15,49,0.128908019936565,0.847983688264613,3174,-0.719075668328047
UT,Garfield County,49017,352,1577,2294,0.153443766346992,0.687445510026155,1225,-0.534001743679163,49017,2157,306,1811,17,49,0.141863699582754,0.839592025961984,1505,-0.69772832637923
UT,Grand County,49019,1932,1934,4456,0.433572710951526,0.434021543985637,2,-0.000448833034111,49019,3812,1678,1917,19,49,0.440188877229801,0.502885624344176,239,-0.062696747114376
UT,Iron County,49021,2104,10025,15354,0.137032695063176,0.652924319395597,7921,-0.515891624332421,49021,13168,1720,11172,21,49,0.130619684082625,0.848420413122722,9452,-0.717800729040097
UT,Juab County,49023,436,2759,4076,0.106967615309127,0.676889106967615,2323,-0.569921491658489,49023,3907,436,3400,23,49,0.111594573841822,0.870232915280266,2964,-0.758638341438444
UT,Kane County,49025,739,2248,3482,0.212234348075819,0.645605973578403,1509,-0.433371625502585,49025,3281,718,2463,25,49,0.218835720816824,0.750685766534593,1745,-0.531850045717769
UT,Millard County,49027,431,3860,5234,0.082346197936569,0.737485670615208,3429,-0.65513947267864,49027,4958,424,4421,27,49,0.085518354175071,0.891690197660347,3997,-0.806171843485276
UT,Morgan County,49029,572,3156,5136,0.111370716510903,0.614485981308411,2584,-0.503115264797508,49029,4370,386,3910,29,49,0.088329519450801,0.894736842105263,3524,-0.806407322654462
UT,Piute County,49031,31,537,617,0.050243111831443,0.870340356564019,506,-0.820097244732577,49031,781,74,696,31,49,0.094750320102433,0.891165172855314,622,-0.796414852752881
UT,Rich County,49033,104,786,1096,0.094890510948905,0.717153284671533,682,-0.622262773722628,49033,999,83,907,33,49,0.083083083083083,0.907907907907908,824,-0.824824824824825
UT,Salt Lake County,49035,154831,117901,361347,0.428482871035321,0.326281939520738,36930,0.102200931514583,49035,341664,132686,198739,35,49,0.388352299335019,0.581679661890044,66053,-0.193327362555025
UT,San Juan County,49037,1997,2635,5385,0.370844939647168,0.489322191272052,638,-0.118477251624884,49037,5159,2062,3006,37,49,0.39968986237643,0.582671060283001,944,-0.182981197906571
UT,Sanpete County,49039,1026,6436,9778,0.104929433421968,0.658212313356515,5410,-0.553282879934547,49039,8804,889,7767,39,49,0.100976828714221,0.882212630622444,6878,-0.781235801908224
UT,Sevier County,49041,673,6455,8308,0.081006259027444,0.77696196437169,5782,-0.695955705344247,49041,7781,701,6961,41,49,0.09009124791158,0.894615088034957,6260,-0.804523840123377
UT,Summit County,49043,10251,7160,20133,0.509164059007599,0.355635027069985,3091,0.153529031937615,49043,16616,7656,8464,43,49,0.460760712566201,0.509388541165142,808,-0.048627828598941
UT,Tooele County,49045,4015,9693,18905,0.212377677862999,0.512721502248083,5678,-0.300343824385083,49045,16422,3794,12240,45,49,0.231031543052003,0.745341614906832,8446,-0.514310071854829
UT,Uintah County,49047,1002,9876,12883,0.077776915314756,0.766591632383762,8874,-0.688814717069006,49047,11116,962,10001,47,49,0.086541921554516,0.899694134580784,9039,-0.813152213026268
UT,Utah County,49049,24579,89755,174942,0.140497993620743,0.513055755621863,65176,-0.37255776200112,49049,161278,15791,142337,49,49,0.097911680452387,0.882556827341609,126546,-0.784645146889222
UT,Wasatch County,49051,3063,6115,12120,0.252722772277228,0.50453795379538,3052,-0.251815181518152,49051,9109,2097,6852,51,49,0.230211878362059,0.752223076078604,4755,-0.522011197716544
UT,Washington County,49053,9583,39566,57494,0.166678262079521,0.688176157512088,29983,-0.521497895432567,49053,49733,7762,41104,53,49,0.156073432127561,0.82649347515734,33342,-0.670420043029779
UT,Wayne County,49055,271,959,1410,0.192198581560284,0.680141843971631,688,-0.487943262411348,49055,1323,213,1087,55,49,0.160997732426304,0.82161753590325,874,-0.660619803476946
UT,Weber County,49057,22187,38447,81451,0.272396901204405,0.472026126137187,16260,-0.199629224932782,49057,68143,17569,48938,57,49,0.257825455292547,0.718166209295159,31369,-0.460340754002612
VT,Addison County,50001,11217,5297,17592,0.637619372442019,0.301102773988176,5920,0.336516598453843,50001,17843,12290,5214,1,50,0.688785518130359,0.292215434624222,7076,0.396570083506137
VT,Bennington County,50003,9539,5925,16345,0.583603548485775,0.362496176200673,3614,0.221107372285102,50003,17512,11517,5687,3,50,0.657663316582914,0.324748743718593,5830,0.332914572864322
VT,Caledonia County,50005,6445,5533,12966,0.49706925805954,0.426731451488508,912,0.070337806571032,50005,13545,8192,5088,5,50,0.604798818752307,0.375636766334441,3104,0.229162052417866
VT,Chittenden County,50007,54463,18298,77263,0.704904029095427,0.236827459456661,36165,0.468076569638766,50007,76531,53615,21567,7,50,0.700565783800029,0.281807372175981,32048,0.418758411624048
VT,Essex County,50009,1019,1506,2706,0.376570583887657,0.556541019955654,487,-0.179970436067997,50009,2769,1539,1169,9,50,0.555796316359697,0.422174070061394,370,0.133622246298303
VT,Franklin County,50011,9351,8752,19373,0.482682083311826,0.451762762607753,599,0.030919320704073,50011,19755,12057,7405,11,50,0.610326499620349,0.374841812199443,4652,0.235484687420906
VT,Grand Isle County,50013,2094,1487,3778,0.554261514028587,0.393594494441503,607,0.160667019587083,50013,4064,2531,1471,13,50,0.622785433070866,0.361958661417323,1060,0.260826771653543
VT,Lamoille County,50015,7241,3570,11641,0.622025599175329,0.306674684305472,3671,0.315350914869857,50015,11924,8371,3352,15,50,0.702029520295203,0.281113720228111,5019,0.420915800067092
VT,Orange County,50017,7522,4997,13464,0.558674985145573,0.371137849079025,2525,0.187537136066548,50017,13964,9075,4588,17,50,0.64988541965053,0.328559152105414,4487,0.321326267545116
VT,Orleans County,50019,5181,5158,10988,0.471514379322898,0.469421186749181,23,0.002093192573717,50019,11631,7116,4306,19,50,0.611813257673459,0.370217522139111,2810,0.241595735534348
VT,Rutland County,50021,13629,12471,27660,0.492733188720173,0.450867678958785,1158,0.041865509761388,50021,28414,17087,10834,21,50,0.601358485253748,0.381290912930246,6253,0.220067572323502
VT,Washington County,50023,18594,7993,28654,0.648914636699937,0.278948837858589,10601,0.369965798841348,50023,29049,20349,8092,23,50,0.700506041516059,0.278563805982994,12257,0.421942235533065
VT,Windham County,50025,14340,5462,21151,0.677982128504562,0.258238381164011,8878,0.419743747340551,50025,21805,16080,5344,25,50,0.737445540013758,0.245081403347856,10736,0.492364136665902
VT,Windsor County,50027,17544,8604,27832,0.630353549870653,0.309140557631503,8940,0.321212992239149,50027,28468,19440,8583,27,50,0.682871996627793,0.301496417029647,10857,0.381375579598145
VA,Accomack County,51001,6737,8582,15755,0.427610282450016,0.54471596318629,1845,-0.117105680736274,51001,16020,7653,8212,1,51,0.477715355805243,0.512609238451935,559,-0.034893882646692
VA,Albemarle County,51003,33297,19232,56134,0.593169914846617,0.342608757615705,14065,0.250561157230912,51003,53732,29712,23263,3,51,0.552966574852974,0.432944986227946,6449,0.120021588625028
VA,Alleghany County,51005,2165,4873,7306,0.296331782096907,0.66698603887216,2708,-0.370654256775253,51005,7162,3403,3595,5,51,0.475146607092991,0.501954761239877,192,-0.026808154146886
VA,Amelia County,51007,2150,4704,7035,0.305614783226724,0.66865671641791,2554,-0.363041933191187,51007,6885,2488,4324,7,51,0.361365286855483,0.62803195352215,1836,-0.266666666666667
VA,Amherst County,51009,4986,9643,15164,0.328805064626748,0.635914006858349,4657,-0.307108942231601,51009,14937,5898,8865,9,51,0.394858405302269,0.593492669210685,2967,-0.198634263908415
VA,Appomattox County,51011,2023,5714,7954,0.254337440281619,0.718380688961529,3691,-0.46404324867991,51011,7924,2453,5340,11,51,0.309565875820293,0.673902069661787,2887,-0.364336193841494
VA,Arlington County,51013,91879,20155,119344,0.769866939267998,0.168881552486929,71724,0.60098538678107,51013,117279,81178,34433,13,51,0.692178480375856,0.293599024548299,46745,0.398579455827556
VA,Augusta County,51015,8108,26152,36661,0.221161452224435,0.713346608112163,18044,-0.492185155887728,51015,33614,9448,23614,15,51,0.281073362289522,0.702504908669007,14166,-0.421431546379485
VA,Bath County,51017,603,1548,2243,0.268836379848417,0.690147124386982,945,-0.421310744538564,51017,2218,894,1274,17,51,0.403065825067629,0.57439134355275,380,-0.171325518485122
VA,Bedford County,51019,9733,30578,42186,0.230716351396198,0.724837623856256,20845,-0.494121272460058,51019,40750,10925,29281,19,51,0.268098159509202,0.718552147239264,18356,-0.450453987730061
VA,Bland County,51021,453,2572,3124,0.145006402048656,0.823303457106274,2119,-0.678297055057618,51021,2937,735,2144,21,51,0.250255362614913,0.729996595165134,1409,-0.479741232550221
VA,Botetourt County,51023,4492,13369,18641,0.240974196663269,0.717182554583981,8877,-0.476208357920712,51023,18208,5449,12471,23,51,0.299264059753954,0.684918717047452,7022,-0.385654657293497
VA,Brunswick County,51025,4473,3045,7645,0.585088293001962,0.398299542184434,1428,0.186788750817528,51025,8029,4993,2965,25,51,0.621870718644912,0.369286337028272,2028,0.25258438161664
VA,Buchanan County,51027,1721,7292,9220,0.186659436008677,0.790889370932755,5571,-0.604229934924078,51027,9636,3094,6436,27,51,0.321087588210876,0.66791199667912,3342,-0.346824408468244
VA,Buckingham County,51029,3128,3969,7284,0.42943437671609,0.544892915980231,841,-0.115458539264141,51029,7447,3747,3569,29,51,0.503155633140862,0.479253390627098,178,0.023902242513764
VA,Campbell County,51031,6597,19442,27218,0.242376368579616,0.71430670879565,12845,-0.471930340216034,51031,25632,7591,17687,31,51,0.296153245942572,0.690035892634207,10096,-0.393882646691635
VA,Caroline County,51033,6425,7143,14189,0.452815561350342,0.503418140813306,718,-0.050602579462964,51033,13590,7258,6148,33,51,0.534069168506255,0.452391464311994,1110,0.081677704194261
VA,Carroll County,51035,2557,10653,13587,0.188194597777287,0.784058291013469,8096,-0.595863693236182,51035,12315,3500,8351,35,51,0.284206252537556,0.678116118554608,4851,-0.393909866017052
VA,Charles City County,51036,2244,1381,3745,0.599198931909212,0.368758344459279,863,0.230440587449933,51036,4213,2772,1396,36,51,0.657963446475196,0.331355328744363,1376,0.326608117730833
VA,Charlotte County,51037,2153,3479,5792,0.371719613259669,0.600656077348066,1326,-0.228936464088398,51037,5897,2502,3311,37,51,0.424283534000339,0.561471934882143,809,-0.137188400881804
VA,Chesterfield County,51041,80993,84938,175288,0.4620567294966,0.484562548491625,3945,-0.022505818995025,51041,172223,78954,91174,41,51,0.458440510268663,0.529395028538581,12220,-0.070954518269918
VA,Clarke County,51043,3047,4657,8131,0.374738654532038,0.572746279670397,1610,-0.198007625138359,51043,7731,3237,4295,43,51,0.418703919285991,0.555555555555556,1058,-0.136851636269564
VA,Craig County,51045,541,2139,2784,0.194324712643678,0.768318965517241,1598,-0.573994252873563,51045,2664,830,1757,45,51,0.311561561561562,0.659534534534535,927,-0.347972972972973
VA,Culpeper County,51047,7744,13341,22087,0.350613483044325,0.604020464526645,5597,-0.25340698148232,51047,20131,8263,11549,47,51,0.410461477323531,0.573692315334559,3286,-0.163230838011028
VA,Cumberland County,51049,2032,2693,4875,0.416820512820513,0.552410256410256,661,-0.135589743589744,51049,5040,2422,2538,49,51,0.480555555555556,0.503571428571429,116,-0.023015873015873
VA,Dickenson County,51051,1335,4932,6405,0.208430913348946,0.770023419203747,3597,-0.561592505854801,51051,6878,2472,4274,51,51,0.359406804303577,0.621401570223902,1802,-0.261994765920326
VA,Dinwiddie County,51053,5765,7447,13533,0.425995714180152,0.550284489765758,1682,-0.124288775585606,51053,13339,6425,6769,53,51,0.481670290126696,0.507459329784841,344,-0.025789039658145
VA,Essex County,51057,2541,2657,5354,0.474598431079567,0.49626447515876,116,-0.021666044079193,51057,5666,3009,2602,57,51,0.531062477938581,0.459230497705612,407,0.071831980232969
VA,Fairfax County,51059,354485,157837,542858,0.6529976531616,0.29075190933909,196648,0.36224574382251,51059,440174,260835,173786,59,51,0.592572482700023,0.394812051597777,87049,0.197760431102246
VA,Fauquier County,51061,12960,22110,37124,0.349100312466329,0.595571597888159,9150,-0.24647128542183,51061,35339,13891,20955,61,51,0.393078468547497,0.592970938623051,7064,-0.199892470075554
VA,Floyd County,51063,2300,5289,7972,0.288509784244857,0.663447064726543,2989,-0.374937280481686,51063,7626,2732,4671,63,51,0.358248098610018,0.612509834775767,1939,-0.254261736165749
VA,Fluvanna County,51065,5751,7018,13492,0.426252594129855,0.520160094871035,1267,-0.09390750074118,51065,12724,5885,6678,65,51,0.462511788745678,0.524834957560516,793,-0.062323168814838
VA,Franklin County,51067,7254,18560,26805,0.270621152770006,0.692408132811043,11306,-0.421786980041037,51067,26633,9082,16685,67,51,0.341005519468329,0.626478429016634,7603,-0.285472909548305
VA,Frederick County,51069,11920,26069,40133,0.297012433658087,0.649565195724217,14149,-0.35255276206613,51069,36272,12683,22851,69,51,0.349663652404058,0.629990074988972,10168,-0.280326422584914
VA,Giles County,51071,1949,5930,8196,0.237798926305515,0.723523670082967,3981,-0.485724743777452,51071,7544,2730,4660,71,51,0.361876988335101,0.617709437963945,1930,-0.255832449628844
VA,Gloucester County,51073,5399,13087,19524,0.276531448473673,0.670303216553985,7688,-0.393771768080311,51073,19246,6764,12137,73,51,0.351449651875714,0.630624545360075,5373,-0.27917489348436
VA,Goochland County,51075,4884,8374,13930,0.350610193826274,0.601148600143575,3490,-0.250538406317301,51075,13287,4676,8448,75,51,0.351922932189358,0.635809437796342,3772,-0.283886505606984
VA,Grayson County,51077,1407,5593,7258,0.193855056489391,0.770597960870763,4186,-0.576742904381372,51077,7146,2094,4801,77,51,0.293031066330814,0.671844388469074,2707,-0.378813322138259
VA,Greene County,51079,2923,5943,9503,0.307587077764916,0.625381458486794,3020,-0.317794380721877,51079,8993,3284,5558,79,51,0.365172912265095,0.618036250416991,2274,-0.252863338151896
VA,Greensville County,51081,2558,1737,4363,0.586293834517534,0.398120559248224,821,0.18817327526931,51081,4925,3135,1766,81,51,0.636548223350254,0.358578680203046,1369,0.277969543147208
VA,Halifax County,51083,6890,9698,16946,0.406585624926236,0.572288445650891,2808,-0.165702820724655,51083,16663,7760,8699,83,51,0.465702454539999,0.522054852067455,939,-0.056352397527456
VA,Hanover County,51085,19360,39592,62313,0.310689583233033,0.635373036124083,20232,-0.32468345289105,51085,58936,18283,39920,85,51,0.310217863445093,0.677344916519614,21637,-0.367127053074521
VA,Henrico County,51087,93615,59674,161966,0.577991677265599,0.368435350629144,33941,0.209556326636455,51087,161195,89116,70235,87,51,0.55284593194578,0.435714507273799,18881,0.117131424671981
VA,Henry County,51089,8199,15207,24029,0.341212701319239,0.632860293811644,7008,-0.291647592492405,51089,24927,10312,13980,89,51,0.413687968869098,0.560837645926104,3668,-0.147149677057006
VA,Highland County,51091,371,958,1391,0.266714593817398,0.688713156002876,587,-0.421998562185478,51091,1411,459,924,91,51,0.325301204819277,0.654854712969525,465,-0.329553508150248
VA,Isle of Wight County,51093,7673,11971,20481,0.374639910160637,0.584492944680436,4298,-0.209853034519799,51093,20772,8754,11797,93,51,0.421432697862507,0.567927979973041,3043,-0.146495282110533
VA,James City County,51095,19091,21284,42737,0.446708940730515,0.498022790556193,2193,-0.051313849825678,51095,41134,17854,22830,95,51,0.434044829095152,0.555015315797151,4976,-0.120970486701998
VA,King and Queen County,51097,1451,2059,3615,0.401383125864454,0.569571230982019,608,-0.168188105117566,51097,3645,1743,1863,97,51,0.478189300411523,0.511111111111111,120,-0.032921810699589
VA,King George County,51099,4002,7338,11967,0.334419654048634,0.613186262221108,3336,-0.278766608172474,51099,11287,4476,6603,99,51,0.396562416939842,0.585009302737663,2127,-0.188446885797821
VA,King William County,51101,2752,5963,9088,0.302816901408451,0.656139964788732,3211,-0.353323063380282,51101,8865,3326,5445,101,51,0.375183305132544,0.614213197969543,2119,-0.239029892836999
VA,Lancaster County,51103,2862,3520,6599,0.433702076072132,0.533414153659645,658,-0.099712077587513,51103,7052,3144,3749,103,51,0.445830969937606,0.531622234826999,605,-0.085791264889393
VA,Lee County,51105,1627,7542,9353,0.173954880786913,0.806372286966749,5915,-0.632417406179835,51105,9588,2593,6845,105,51,0.270442219440968,0.713913224864414,4252,-0.443471005423446
VA,Loudoun County,51107,99909,69633,180265,0.554234044323635,0.386281308074224,30276,0.167952736249411,51107,158648,81900,74794,107,51,0.516237204376986,0.471446220563764,7106,0.044790983813222
VA,Louisa County,51109,6208,10507,17507,0.354601016736163,0.60015993602559,4299,-0.245558919289427,51109,16404,6949,9207,109,51,0.423616191172885,0.561265544989027,2258,-0.137649353816142
VA,Lunenburg County,51111,2226,3206,5577,0.399139322216245,0.574861036399498,980,-0.175721714183253,51111,5726,2684,2969,111,51,0.468739084876004,0.518512050296891,285,-0.049772965420887
VA,Madison County,51113,2202,4418,6934,0.317565618690511,0.637150274012114,2216,-0.319584655321604,51113,6597,2637,3864,113,51,0.399727148703956,0.585720782173715,1227,-0.185993633469759
VA,Mathews County,51115,1563,3515,5292,0.295351473922902,0.664210128495843,1952,-0.36885865457294,51115,5364,1807,3488,115,51,0.336875466070097,0.650260999254288,1681,-0.313385533184191
VA,Mecklenburg County,51117,6571,8283,15177,0.432957765039204,0.545760031626804,1712,-0.1128022665876,51117,14813,6786,7855,117,51,0.45811111861203,0.530277458988726,1069,-0.072166340376696
VA,Middlesex County,51119,2107,3668,5994,0.351518184851518,0.611945278611945,1561,-0.260427093760427,51119,6067,2370,3619,119,51,0.390637877039723,0.596505686500742,1249,-0.205867809461019
VA,Montgomery County,51121,20015,19455,42695,0.468790256470313,0.455673966506617,560,0.013116289963696,51121,40938,19903,20006,121,51,0.48617421466608,0.488690214470663,103,-0.002515999804583
VA,Nelson County,51125,3677,4150,8247,0.445859100278889,0.503213289681096,473,-0.057354189402207,51125,8225,4171,3944,125,51,0.507112462006079,0.47951367781155,227,0.027598784194529
VA,New Kent County,51127,3545,8117,12163,0.291457699580696,0.667351804653457,4572,-0.375894105072762,51127,10941,3555,7246,127,51,0.324924595557993,0.662279499131707,3691,-0.337354903573714
VA,Northampton County,51131,3255,2686,6134,0.530648842517118,0.437887186175416,569,0.092761656341702,51131,6481,3737,2676,131,51,0.57660854806357,0.412899243943836,1061,0.163709304119735
VA,Northumberland County,51133,2830,5089,8176,0.346135029354207,0.622431506849315,2259,-0.276296477495108,51133,7542,3186,4308,133,51,0.422434367541766,0.571201272871917,1122,-0.148766905330151
VA,Nottoway County,51135,2829,3712,6717,0.421170165252345,0.552627661158255,883,-0.13145749590591,51135,6844,3344,3409,135,51,0.488603156049094,0.498100526008182,65,-0.009497369959088
VA,Orange County,51137,5955,10511,17157,0.347088651862214,0.612636241767209,4556,-0.265547589904995,51137,16330,6870,9244,137,51,0.420698101653399,0.566074709124311,2374,-0.145376607470912
VA,Page County,51139,2514,7824,10663,0.235768545437494,0.733752227328144,5310,-0.49798368189065,51139,10205,3724,6344,139,51,0.364919157275845,0.621656050955414,2620,-0.256736893679569
VA,Patrick County,51141,1768,6454,8489,0.208269525267994,0.760278006832371,4686,-0.552008481564377,51141,8241,2417,5622,141,51,0.293289649314404,0.68219876228613,3205,-0.388909112971727
VA,Pittsylvania County,51143,9195,21742,31687,0.290182093603055,0.686148893868148,12547,-0.395966800265093,51143,30578,10855,19275,143,51,0.354993786382366,0.630355157302636,8420,-0.275361370920269
VA,Powhatan County,51145,4057,11875,16794,0.241574371799452,0.707097773014172,7818,-0.46552340121472,51145,15466,4066,11192,145,51,0.262899262899263,0.723651881546618,7126,-0.460752618647356
VA,Prince Edward County,51147,4590,4099,9113,0.503676067156809,0.449796993306266,491,0.053879073850543,51147,9224,5132,3952,147,51,0.556374674761492,0.428447528187337,1180,0.127927146574154
VA,Prince George County,51149,6419,9157,16140,0.397707558859975,0.567348203221809,2738,-0.169640644361834,51149,17180,7671,9350,149,51,0.4465075669383,0.544237485448196,1679,-0.097729918509895
VA,Prince William County,51153,83093,54065,144854,0.573632761263065,0.373237880900769,29028,0.200394880362296,51153,179648,103161,74371,153,51,0.574239624153901,0.413981786604916,28790,0.160257837548985
VA,Pulaski County,51155,4170,10314,15112,0.275939650608788,0.682503970354685,6144,-0.406564319745897,51155,14657,5287,8917,155,51,0.360715016715563,0.608378249300675,3630,-0.247663232585113
VA,Rappahannock County,51157,1741,2532,4444,0.391764176417642,0.56975697569757,791,-0.177992799279928,51157,4331,1971,2307,157,51,0.455091202955438,0.532671438466867,336,-0.077580235511429
VA,Richmond County,51159,1347,2213,3651,0.368940016433854,0.606135305395782,866,-0.237195288961928,51159,3768,1574,2160,159,51,0.417728237791932,0.573248407643312,586,-0.15552016985138
VA,Roanoke County,51161,16787,30857,50149,0.334742467447008,0.615306386966839,14070,-0.280563919519831,51161,53793,19589,33344,161,51,0.364155187477925,0.619857602290261,13755,-0.255702414812336
VA,Rockbridge County,51163,3506,6671,10685,0.32812353766963,0.624333177351427,3165,-0.296209639681797,51163,10155,4087,5898,163,51,0.40246184145741,0.580797636632201,1811,-0.178335795174791
VA,Rockingham County,51165,9361,25269,36536,0.256213050142325,0.691619224874097,15908,-0.435406174731771,51165,34783,10059,24173,165,51,0.289192996578788,0.694965931633269,14114,-0.405772935054481
VA,Russell County,51167,2328,9516,12195,0.19089790897909,0.780319803198032,7188,-0.589421894218942,51167,12063,3716,8177,167,51,0.308049407278455,0.677857912625383,4461,-0.369808505346929
VA,Scott County,51169,1579,8242,10055,0.157036300348086,0.819691695673794,6663,-0.662655395325709,51169,9964,2395,7439,169,51,0.240365315134484,0.746587715776797,5044,-0.506222400642312
VA,Shenandoah County,51171,5269,14078,20335,0.25910990902385,0.692303909515614,8809,-0.433194000491763,51171,19289,6462,12526,171,51,0.335009590958577,0.649385660220851,6064,-0.314376069262274
VA,Smyth County,51173,2661,9747,12825,0.207485380116959,0.76,7086,-0.552514619883041,51173,12751,4169,8376,173,51,0.326954748647165,0.656889655713277,4207,-0.329934907066112
VA,Southampton County,51175,3595,5035,8872,0.405207394048693,0.567515779981966,1440,-0.162308385933273,51175,9261,4437,4733,175,51,0.47910592808552,0.511067919231185,296,-0.031961991145665
VA,Spotsylvania County,51177,24204,34619,62083,0.38986518048419,0.557624470466956,10415,-0.167759289982765,51177,57797,25150,31818,177,51,0.4351436925792,0.550513002404969,6668,-0.11536930982577
VA,Stafford County,51179,27879,33840,65350,0.426610558530987,0.517827084927314,5961,-0.091216526396328,51179,60338,27130,32429,179,51,0.449633729987736,0.537455666412543,5299,-0.087821936424807
VA,Surry County,51181,2069,1785,3976,0.520372233400402,0.448943661971831,284,0.071428571428571,51181,4302,2574,1671,181,51,0.598326359832636,0.388423988842399,903,0.209902370990237
VA,Sussex County,51183,2874,2055,5036,0.570691024622716,0.408061953931692,819,0.162629070691025,51183,5421,3350,2021,183,51,0.617967164729755,0.372809444751891,1329,0.245157719977864
VA,Tazewell County,51185,2895,15160,18495,0.156528791565288,0.819680994863477,12265,-0.663152203298189,51185,17712,3661,13843,185,51,0.206696025293586,0.781560523938573,10182,-0.574864498644986
VA,Warren County,51187,5165,11762,17791,0.290315327974819,0.661120791411388,6597,-0.370805463436569,51187,16636,6449,9865,187,51,0.387653282038952,0.59299110363068,3416,-0.205337821591729
VA,Washington County,51191,5548,19309,25715,0.215749562512152,0.750884697647288,13761,-0.535135135135135,51191,25582,7076,18141,191,51,0.276600734891721,0.70913142053006,11065,-0.432530685638339
VA,Westmoreland County,51193,3723,4331,8291,0.44904112893499,0.522373658183573,608,-0.073332529248583,51193,8689,4155,4116,193,51,0.47819081597422,0.473702382322477,39,0.004488433651744
VA,Wise County,51195,2687,11983,14991,0.179240877860049,0.799346274431325,9296,-0.620105396571276,51195,14937,3751,11041,195,51,0.251121376447747,0.739171185646381,7290,-0.488049809198634
VA,Wythe County,51197,2765,10044,13250,0.208679245283019,0.758037735849057,7279,-0.549358490566038,51197,12336,3782,8324,197,51,0.306582360570687,0.674773022049287,4542,-0.368190661478599
VA,York County,51199,12989,18823,34062,0.381334037930832,0.552609946568023,5834,-0.171275908637191,51199,33848,13165,20182,199,51,0.388944693925786,0.596253840699598,7017,-0.207309146773812
VA,Alexandria city,51510,57147,13241,74384,0.768270058077006,0.178008711550871,43906,0.590261346526135,51510,73470,52434,20205,510,51,0.713679052674561,0.275010208248265,32229,0.438668844426296
VA,Bristol city,51520,1832,4884,6966,0.262991673844387,0.701119724375538,3052,-0.438128050531151,51520,7356,2487,4776,520,51,0.338091353996737,0.649265905383361,2289,-0.311174551386623
VA,Buena Vista city,51530,693,1432,2395,0.289352818371608,0.597912317327766,739,-0.308559498956159,51530,2526,919,1564,530,51,0.36381631037213,0.619160728424386,645,-0.255344418052257
VA,Charlottesville city,51540,17865,2951,22211,0.804331187249561,0.132862095358156,14914,0.671469091891405,51540,21455,16267,4801,540,51,0.758191563738056,0.223770682824516,11466,0.53442088091354
VA,Chesapeake city,51550,52554,53988,111827,0.469958060218015,0.482781439187316,1434,-0.012823378969301,51550,110105,54999,53845,550,51,0.499514100177104,0.489033195586032,1154,0.010480904591072
VA,Colonial Heights city,51570,2367,5681,8427,0.280882876468494,0.674142636762786,3314,-0.393259760294292,51570,8593,2541,5937,570,51,0.295705807052252,0.69091120679623,3396,-0.395205399743978
VA,Covington city,51580,914,1349,2369,0.385816800337695,0.569438581680034,435,-0.183621781342339,51580,2329,1319,975,580,51,0.566337483898669,0.418634607127523,344,0.147702876771146
VA,Danville city,51590,11051,7306,18862,0.585886968508112,0.387339624642138,3745,0.198547343865974,51590,20169,12215,7756,590,51,0.605632406167881,0.384550547870494,4459,0.221081858297387
VA,Emporia city,51595,1531,792,2367,0.646810308407267,0.334600760456274,739,0.312209547950993,51595,2691,1793,886,595,51,0.666295057599405,0.32924563359346,907,0.337049424005946
VA,Fairfax city,51600,7363,3695,11854,0.621140543276531,0.311709127720601,3668,0.30943141555593,51600,11577,6636,4762,600,51,0.573205493651205,0.411332815064352,1874,0.161872678586853
VA,Falls Church city,51610,5810,1323,7667,0.757793139428721,0.172557714881962,4487,0.585235424546759,51610,7244,5006,2141,610,51,0.691054665930425,0.295554942020983,2865,0.395499723909442
VA,Franklin city,51620,2516,1421,4040,0.622772277227723,0.351732673267327,1095,0.271039603960396,51620,4351,2830,1496,620,51,0.650425189611584,0.343829004826477,1334,0.306596184785107
VA,Fredericksburg city,51630,6690,3731,11135,0.600808262236192,0.335069600359228,2959,0.265738661876964,51630,11396,7114,4054,630,51,0.624254124254124,0.355738855738856,3060,0.268515268515269
VA,Galax city,51640,680,1603,2363,0.287769784172662,0.678374947101143,923,-0.390605162928481,51640,2273,900,1332,640,51,0.395952485701716,0.586009678838539,432,-0.190057193136824
VA,Hampton city,51650,41030,17802,61489,0.667273821333897,0.289515197840264,23228,0.377758623493633,51650,71713,51733,19193,650,51,0.72138942730049,0.267636272363449,32540,0.453753154937041
VA,Harrisonburg city,51660,10100,6232,17693,0.570847227717176,0.352229695359747,3868,0.21861753235743,51660,15541,8650,6564,660,51,0.556592239881603,0.422366643073161,2086,0.134225596808442
VA,Hopewell city,51670,4722,3885,8968,0.526538804638715,0.433206958073149,837,0.093331846565567,51670,9011,5178,3737,670,51,0.574631006547553,0.414715347908112,1441,0.159915658639441
VA,Lexington city,51678,1514,766,2448,0.618464052287582,0.312908496732026,748,0.305555555555556,51678,2677,1484,1146,678,51,0.554351886440045,0.428091146806126,338,0.126260739633919
VA,Lynchburg city,51680,14787,17979,35349,0.41831452091997,0.508614105066621,3192,-0.090299584146652,51680,36242,15905,19752,680,51,0.438855471552343,0.545003035152585,3847,-0.106147563600243
VA,Manassas city,51683,8395,5934,15210,0.551939513477975,0.390138067061144,2461,0.161801446416831,51683,15154,8478,6463,683,51,0.559456249175135,0.426488055958823,2015,0.132968193216312
VA,Manassas Park city,51685,3218,1732,5214,0.617184503260453,0.332182585347142,1486,0.28500191791331,51685,4627,2873,1696,685,51,0.620920682947914,0.366544197103955,1177,0.254376485843959
VA,Martinsville city,51690,3531,2149,5873,0.601225949259322,0.365911799761621,1382,0.235314149497701,51690,6277,3855,2312,690,51,0.614146885454835,0.368328819499761,1543,0.245818065955074
VA,Newport News city,51700,40997,23650,68432,0.599091068505962,0.345598550385784,17347,0.253492518120178,51700,79169,50990,27224,700,51,0.644065227551188,0.343871970089303,23766,0.300193257461885
VA,Norfolk city,51710,51429,19875,75172,0.684151013675305,0.264393657212792,31554,0.419757356462513,51710,77925,55654,21366,710,51,0.714199550850177,0.274186717998075,34288,0.440012832852101
VA,Norton city,51720,383,1021,1456,0.263049450549451,0.701236263736264,638,-0.438186813186813,51720,1486,566,895,720,51,0.380888290713324,0.60228802153432,329,-0.221399730820996
VA,Petersburg city,51730,12005,1448,13717,0.875191368375009,0.105562440766932,10557,0.769628927608078,51730,15977,14377,1526,730,51,0.899856043061901,0.095512298929712,12851,0.80434374413219
VA,Poquoson city,51735,1599,5089,7114,0.224768062974417,0.715350014056789,3490,-0.490581951082373,51735,7098,1679,5312,735,51,0.236545505776275,0.748379825302902,3633,-0.511834319526627
VA,Portsmouth city,51740,28462,12773,43000,0.661906976744186,0.297046511627907,15689,0.364860465116279,51740,41860,28994,12407,740,51,0.692642140468228,0.296392737697085,16587,0.396249402771142
VA,Radford city,51750,2923,2637,6032,0.484582228116711,0.437168435013263,286,0.047413793103448,51750,5382,2732,2520,750,51,0.507617985878855,0.468227424749164,212,0.039390561129692
VA,Richmond city,51760,74640,14254,94724,0.787973480849626,0.150479287192264,60386,0.637494193657362,51760,92175,71037,19732,760,51,0.770675345809601,0.214071060482777,51305,0.556604285326824
VA,Roanoke city,51770,23403,16045,41728,0.56084643404908,0.384513995398773,7358,0.176332438650307,51770,37479,22179,14116,770,51,0.591771391979509,0.376637583713546,8063,0.215133808265962
VA,Salem city,51775,4212,7225,12129,0.347266881028939,0.595679775744084,3013,-0.248412894715145,51775,12270,4756,7289,775,51,0.38761206193969,0.594050529747351,2533,-0.206438467807661
VA,Staunton city,51790,5329,5129,11144,0.478194544149318,0.460247666905958,200,0.01794687724336,51790,11154,5710,5257,790,51,0.511923973462435,0.47131074054151,453,0.040613232920925
VA,Suffolk city,51800,23012,17206,41929,0.548832550263541,0.410360371103532,5806,0.138472179160009,51800,42381,24194,17778,800,51,0.570869021495481,0.419480427550081,6416,0.1513885939454
VA,Virginia Beach city,51810,76744,84389,171876,0.446507947590123,0.490987688798902,7645,-0.044479741208778,51810,195823,94163,99107,810,51,0.480857713343172,0.506105002987392,4944,-0.02524728964422
VA,Waynesboro city,51820,3762,4798,9114,0.412771560236998,0.526442835198596,1036,-0.113671274961598,51820,8772,3836,4789,820,51,0.437300501595987,0.54594163246694,953,-0.108641130870953
VA,Williamsburg city,51830,5199,1921,7534,0.690071675073002,0.254977435625166,3278,0.435094239447836,51830,7722,4901,2678,830,51,0.634680134680135,0.346801346801347,2223,0.287878787878788
VA,Winchester city,51840,5161,4786,10574,0.488083979572536,0.452619633062228,375,0.035464346510308,51840,10254,5089,4943,840,51,0.496294129120343,0.482055783109031,146,0.014238346011313
WA,Adams County,53001,1118,2740,4081,0.273952462631708,0.671404067630483,1622,-0.397451604998775,53001,4707,1516,3111,1,53,0.322073507541959,0.660930528999363,1595,-0.338857021457404
WA,Asotin County,53003,3118,5712,9684,0.321974390747625,0.589838909541512,2594,-0.267864518793887,53003,9883,3993,5647,3,53,0.404027117272083,0.571385206920975,1654,-0.167358089648892
WA,Benton County,53005,25173,45594,76907,0.327317409338552,0.592845904794102,20421,-0.26552849545555,53005,78874,27846,49105,5,53,0.353044095646221,0.622575246595836,21259,-0.269531150949616
WA,Chelan County,53007,10770,15070,27415,0.392850629217582,0.549699069852271,4300,-0.156848440634689,53007,30952,12519,17741,7,53,0.404464978030499,0.573177823727061,5222,-0.168712845696562
WA,Clallam County,53009,15154,15685,32985,0.459420948916174,0.47551917538275,531,-0.016098226466576,53009,35242,17231,17087,9,53,0.488933658702684,0.484847624992906,144,0.004086033709778
WA,Clark County,53011,90697,90590,195784,0.46325031667552,0.462703796020104,107,0.000546520655416,53011,181567,88822,88629,11,53,0.48919682541431,0.48813385692334,193,0.00106296849097
WA,Columbia County,53013,523,1491,2171,0.240902809765085,0.686780285582681,968,-0.445877475817596,53013,2222,634,1545,13,53,0.285328532853285,0.695319531953195,911,-0.40999099909991
WA,Cowlitz County,53015,17842,24066,45485,0.392261185006046,0.52909750467187,6224,-0.136836319665824,53015,40976,20897,19107,15,53,0.509981452557595,0.466297344787192,1790,0.043684107770402
WA,Douglas County,53017,3600,7208,11467,0.313944362082498,0.628586378302956,3608,-0.314642016220459,53017,14678,5047,9287,17,53,0.343847935686061,0.632715628832266,4240,-0.288867693146205
WA,Ferry County,53019,1091,2178,3560,0.306460674157303,0.611797752808989,1087,-0.305337078651685,53019,3391,1276,1966,19,53,0.376290179887939,0.579769979357122,690,-0.203479799469183
WA,Franklin County,53021,7839,11358,20584,0.380829770695686,0.551787796346677,3519,-0.170958025650991,53021,18940,6876,11657,21,53,0.363041182682154,0.615469904963041,4781,-0.252428722280887
WA,Garfield County,53023,276,841,1232,0.224025974025974,0.68262987012987,565,-0.458603896103896,53023,1275,335,912,23,53,0.262745098039216,0.715294117647059,577,-0.452549019607843
WA,Grant County,53025,7768,18482,28260,0.274876150035386,0.653998584571833,10714,-0.379122434536447,53025,27041,8746,17570,25,53,0.32343478421656,0.649754077142118,8824,-0.326319292925557
WA,Grays Harbor County,53027,11378,13269,26736,0.425568521843208,0.496297127468582,1891,-0.070728605625374,53027,28224,15692,11743,27,53,0.555980725623583,0.416064342403628,3949,0.139916383219955
WA,Island County,53029,20766,18259,42425,0.489475545079552,0.430383028874484,2507,0.059092516205068,53029,41319,21080,19251,29,53,0.510176916188678,0.465911566107602,1829,0.044265350081077
WA,Jefferson County,53031,12556,5986,20100,0.624676616915423,0.297810945273632,6570,0.326865671641791,53031,18717,11985,6113,31,53,0.640326975476839,0.326601485280761,5872,0.313725490196078
WA,King County,53033,657149,197781,910823,0.72148924653857,0.217145372920974,459368,0.504343873617596,53033,871654,599796,252090,33,53,0.688112484999782,0.289208791561789,347706,0.398903693437993
WA,Kitsap County,53035,60561,46762,118625,0.510524762908325,0.394200210748156,13799,0.116324552160169,53035,109919,59701,47468,35,53,0.543136309464242,0.431845267879075,12233,0.111291041585167
WA,Kittitas County,53037,7190,9845,18334,0.392167557543362,0.53698047343733,2655,-0.144812915893968,53037,15152,6462,8372,37,53,0.426478352692714,0.552534318901795,1910,-0.126055966209081
WA,Klickitat County,53039,3781,5390,9859,0.383507455117152,0.546708591135004,1609,-0.163201136017852,53039,9861,4373,5138,39,53,0.443464151708752,0.521042490619613,765,-0.077578338910861
WA,Lewis County,53041,7236,16273,24995,0.289497899579916,0.651050210042008,9037,-0.361552310462092,53041,26348,9772,15954,41,53,0.370882040382572,0.60551085471383,6182,-0.234628814331259
WA,Lincoln County,53043,1238,4095,5692,0.217498243148278,0.719430780042164,2857,-0.501932536893886,53043,5804,1649,4024,43,53,0.284114403859407,0.693314955203308,2375,-0.409200551343901
WA,Mason County,53045,11872,13539,27767,0.427557892462275,0.487593186156229,1667,-0.060035293693953,53045,27897,14568,12637,45,53,0.522206688891279,0.452987776463419,1931,0.06921891242786
WA,Okanogan County,53047,3980,6305,10893,0.365372257413018,0.578812081153034,2325,-0.213439823740016,53047,12781,5259,7151,47,53,0.411470151005399,0.559502386354745,1892,-0.148032235349347
WA,Pacific County,53049,4597,5338,10667,0.430955282647417,0.500421861816818,741,-0.069466579169401,53049,10477,5684,4484,49,53,0.542521714231173,0.427985110241481,1200,0.114536603989692
WA,Pend Oreille County,53051,1932,4364,6788,0.284619917501473,0.642899233942251,2432,-0.358279316440778,53051,6649,2501,3942,51,53,0.376146788990826,0.592871108437359,1441,-0.216724319446533
WA,Pierce County,53053,160306,136046,322592,0.496931108024998,0.421727755183018,24260,0.07520335284198,53053,332134,180478,144026,53,53,0.543389114032288,0.433638230352809,36452,0.109750883679479
WA,San Juan County,53055,7053,2651,10589,0.666068561714987,0.25035414108981,4402,0.415714420625177,53055,10345,6943,3061,55,53,0.671145480908652,0.295891735137748,3882,0.375253745770904
WA,Skagit County,53057,26076,24330,54831,0.475570389013514,0.443727088690704,1746,0.03184330032281,53057,42273,21875,19418,57,53,0.517469779764862,0.459347574101672,2457,0.058122205663189
WA,Skamania County,53059,2207,2910,5587,0.395024163236084,0.52085197780562,703,-0.125827814569536,53059,5326,2554,2624,59,53,0.479534359744649,0.492677431468269,70,-0.01314307172362
WA,Snohomish County,53061,167943,116433,309496,0.542633830485693,0.376201954144803,51510,0.16643187634089,53061,298759,169927,121642,61,53,0.568776170759709,0.407157608641079,48285,0.161618562118631
WA,Spokane County,53063,86590,103846,208081,0.416136023952211,0.499065267852423,17256,-0.082929243900212,53063,202088,91977,104797,63,53,0.455133407228534,0.518571117532956,12820,-0.063437710304422
WA,Stevens County,53065,4348,11059,16438,0.264509064363061,0.672770410025551,6711,-0.408261345662489,53065,17281,6014,10794,65,53,0.348012267808576,0.624616630982003,4780,-0.276604363173427
WA,Thurston County,53067,65015,46219,122301,0.531598269842438,0.377911873165387,18796,0.153686396677051,53067,111652,64879,43703,67,53,0.581082291405438,0.391421559846666,21176,0.189660731558772
WA,Wahkiakum County,53069,824,1328,2333,0.353193313330476,0.569224174882126,504,-0.21603086155165,53069,2285,1091,1115,69,53,0.47746170678337,0.487964989059081,24,-0.010503282275711
WA,Walla Walla County,53071,7550,10775,19718,0.382898874125165,0.546455015721676,3225,-0.163556141596511,53071,15155,5713,9098,71,53,0.376971296601782,0.600329924117453,3385,-0.223358627515671
WA,Whatcom County,53073,59402,40247,108223,0.548885172283156,0.371889524407935,19155,0.176995647875221,53073,91158,49743,38764,73,53,0.545678931086685,0.425239693718599,10979,0.120439237368086
WA,Whitman County,53075,5521,5462,12128,0.455227572559367,0.450362796833773,59,0.004864775725594,53075,14851,6910,7460,75,53,0.465288532758737,0.502323075887146,550,-0.037034543128409
WA,Yakima County,53077,28484,39593,72306,0.393936879373773,0.547575581556164,11109,-0.153638702182391,53077,62449,25945,35381,77,53,0.415459014555878,0.566558311582251,9436,-0.151099297026374
WV,Barbour County,54001,1213,4509,6024,0.201361221779548,0.748505976095618,3296,-0.547144754316069,54001,5733,1761,3804,1,54,0.307169021454736,0.663526949241235,2043,-0.356357927786499
WV,Berkeley County,54003,12287,28210,42770,0.287280804302081,0.659574468085106,15923,-0.372293663783025,54003,36804,14122,21956,3,54,0.383708292576894,0.596565590696663,7834,-0.21285729811977
WV,Boone County,54005,1783,6483,8654,0.206031892766351,0.749133348740467,4700,-0.543101455974116,54005,8434,2777,5414,5,54,0.329262508892578,0.641925539483045,2637,-0.312663030590467
WV,Braxton County,54007,1315,3516,5063,0.259727434327474,0.694449930871025,2201,-0.434722496543551,54007,4756,1985,2692,7,54,0.417367535744323,0.566021867115223,707,-0.1486543313709
WV,Brooke County,54009,2549,6574,9540,0.267190775681342,0.689098532494759,4025,-0.421907756813417,54009,9224,3984,5014,9,54,0.431916738941891,0.543581960104076,1030,-0.111665221162186
WV,Cabell County,54011,11306,19648,32701,0.345738662426225,0.6008378948656,8342,-0.255099232439375,54011,31744,13380,17779,11,54,0.421496975806452,0.560074344758065,4399,-0.138577368951613
WV,Calhoun County,54013,456,2023,2604,0.175115207373272,0.776881720430108,1567,-0.601766513056836,54013,2157,801,1288,13,54,0.37134909596662,0.597125637459434,487,-0.225776541492814
WV,Clay County,54015,566,2289,2958,0.191345503718729,0.773833671399594,1723,-0.582488167680866,54015,2989,922,1957,15,54,0.308464369354299,0.654734024757444,1035,-0.346269655403145
WV,Doddridge County,54017,360,2347,2826,0.127388535031847,0.830502476999292,1987,-0.703113941967445,54017,2743,571,2108,17,54,0.208166241341597,0.768501640539555,1537,-0.560335399197959
WV,Fayette County,54019,4246,10263,15187,0.279581220780931,0.67577533416738,6017,-0.396194113386449,54019,13971,5368,8304,19,54,0.384224464963138,0.594374060554005,2936,-0.210149595590867
WV,Gilmer County,54021,537,1889,2528,0.212420886075949,0.747231012658228,1352,-0.534810126582279,54021,2482,830,1580,21,54,0.334407735697019,0.636583400483481,750,-0.302175664786462
WV,Grant County,54023,510,4338,4945,0.103134479271992,0.877249747219413,3828,-0.774115267947422,54023,4572,713,3775,23,54,0.155949256342957,0.825678040244969,3062,-0.669728783902012
WV,Greenbrier County,54025,3743,9499,13984,0.267663043478261,0.679276315789474,5756,-0.411613272311213,54025,12872,4681,7873,25,54,0.363657551274083,0.61163766314481,3192,-0.247980111870727
WV,Hampshire County,54027,1576,6646,8557,0.184176697440692,0.776674068014491,5070,-0.592497370573799,54027,7972,2294,5514,27,54,0.287757150025088,0.691670847967888,3220,-0.4039136979428
WV,Hancock County,54029,3247,8870,12642,0.256842271792438,0.701629489004904,5623,-0.444787217212466,54029,11991,4571,7159,29,54,0.381202568593111,0.597031106663331,2588,-0.215828538070219
WV,Hardy County,54031,1249,4544,6022,0.207406177349718,0.754566589173032,3295,-0.547160411823315,54031,5149,1477,3523,31,54,0.28685181588658,0.68421052631579,2046,-0.39735871042921
WV,Harrison County,54033,7675,18687,27868,0.275405482991244,0.670554040476532,11012,-0.395148557485288,54033,25948,9660,15755,33,54,0.372283027593649,0.607175890242022,6095,-0.234892862648374
WV,Jackson County,54035,2648,8959,12108,0.218698381235547,0.739924017178725,6311,-0.521225635943178,54035,11465,3824,7360,35,54,0.333536851286524,0.641953772350632,3536,-0.308416921064108
WV,Jefferson County,54037,9458,13144,24007,0.393968425875786,0.54750697713167,3686,-0.153538551255884,54037,21776,10215,11090,37,54,0.469094415870683,0.509276267450404,875,-0.040181851579721
WV,Kanawha County,54039,27985,43464,74996,0.373153234839191,0.579550909381834,15479,-0.206397674542642,54039,74451,32190,41037,39,54,0.432364911149615,0.551194745537333,8847,-0.118829834387718
WV,Lewis County,54041,1336,5245,6885,0.194045025417574,0.761801016702978,3909,-0.567755991285403,54041,6243,1719,4349,41,54,0.275348390197021,0.696620214640397,2630,-0.421271824443377
WV,Lincoln County,54043,1435,5257,6988,0.205352032054951,0.752289639381797,3822,-0.546937607326846,54043,6747,2204,4336,43,54,0.326663702386246,0.642655995257151,2132,-0.315992292870906
WV,Logan County,54045,2082,9866,12315,0.169062119366626,0.80113682501015,7784,-0.632074705643524,54045,11901,3461,8186,45,54,0.290815897823712,0.687841357869087,4725,-0.397025460045374
WV,McDowell County,54047,1429,4614,6179,0.231267195339052,0.746722770674866,3185,-0.515455575335815,54047,6136,2086,3931,47,54,0.339960886571056,0.640645371577575,1845,-0.300684485006519
WV,Marion County,54049,6926,14592,22910,0.302313400261894,0.63692710606722,7666,-0.334613705805325,54049,21414,8905,11981,49,54,0.415849444288783,0.559493789109928,3076,-0.143644344821145
WV,Marshall County,54051,2894,9565,13083,0.221203087976764,0.731101429335779,6671,-0.509898341359015,54051,9849,3395,6208,51,54,0.344705046197583,0.630317798761296,2813,-0.285612752563712
WV,Mason County,54053,2069,7597,10115,0.204547701433515,0.751062778052397,5528,-0.546515076618883,54053,9713,3738,5706,53,54,0.384845053021723,0.587460105013899,1968,-0.202615051992175
WV,Mercer County,54055,4689,17362,22919,0.204590078101139,0.757537414372355,12673,-0.552947336271216,54055,21216,5416,15406,55,54,0.255279034690799,0.726150075414781,9990,-0.470871040723982
WV,Mineral County,54057,2019,8957,11410,0.176950043821209,0.78501314636284,6938,-0.60806310254163,54057,10784,2836,7687,57,54,0.262982195845697,0.71281528189911,4851,-0.449833086053413
WV,Mingo County,54059,1365,7876,9469,0.14415460977928,0.831766818037808,6511,-0.687612208258528,54059,8794,2421,6163,59,54,0.275301341823971,0.700818740050034,3742,-0.425517398226063
WV,Monongalia County,54061,14568,18278,35733,0.407690370245991,0.511515965634008,3710,-0.103825595388017,54061,31140,13664,16672,61,54,0.438792549775209,0.53538856775851,3008,-0.096596017983301
WV,Monroe County,54063,1089,4337,5670,0.192063492063492,0.764902998236332,3248,-0.57283950617284,54063,5152,1441,3571,63,54,0.279697204968944,0.693128881987578,2130,-0.413431677018633
WV,Morgan County,54065,1568,5718,7635,0.205370006548788,0.748919449901768,4150,-0.54354944335298,54065,7037,2361,4508,65,54,0.335512292169959,0.640613897967884,2147,-0.305101605797925
WV,Nicholas County,54067,1821,7169,9385,0.194033031433138,0.76387852956846,5348,-0.569845498135322,54067,8676,2635,5823,67,54,0.303711387736284,0.671161825726141,3188,-0.367450437989857
WV,Ohio County,54069,5452,11077,17819,0.305965542398563,0.621639822661204,5625,-0.315674280262641,54069,17541,6623,10577,69,54,0.377572544324725,0.602987286927769,3954,-0.225414742603044
WV,Pendleton County,54071,726,2388,3212,0.226027397260274,0.74346201743462,1662,-0.517434620174346,54071,3224,1067,2087,71,54,0.330955334987593,0.647332506203474,1020,-0.316377171215881
WV,Pleasants County,54073,620,2342,3130,0.198083067092652,0.748242811501597,1722,-0.550159744408946,54073,2807,942,1805,73,54,0.335589597434984,0.643035268970431,863,-0.307445671535447
WV,Pocahontas County,54075,924,2474,3619,0.25531914893617,0.683614258082343,1550,-0.428295109146173,54075,3553,1298,2167,75,54,0.365325077399381,0.609907120743034,869,-0.244582043343653
WV,Preston County,54077,2462,9501,12611,0.195226389659821,0.75338989770835,7039,-0.558163508048529,54077,11089,2916,7841,77,54,0.262963296960952,0.707097123275318,4925,-0.444133826314366
WV,Putnam County,54079,5784,17455,24443,0.23663216462791,0.714110379249683,11671,-0.477478214621773,54079,23501,7198,15926,79,54,0.306284838943024,0.677673290498277,8728,-0.371388451555253
WV,Raleigh County,54081,6362,21835,29311,0.217051618846167,0.744942171880864,15473,-0.527890553034697,54081,28499,7651,20375,81,54,0.268465560195095,0.714937366223376,12724,-0.446471806028282
WV,Randolph County,54083,2724,7583,10816,0.251849112426035,0.701090976331361,4859,-0.449241863905325,54083,9727,3325,6150,83,54,0.3418320139817,0.632260717590213,2825,-0.290428703608512
WV,Ritchie County,54085,490,3376,4040,0.121287128712871,0.835643564356436,2886,-0.714356435643564,54085,3749,762,2889,85,54,0.203254201120299,0.770605494798613,2127,-0.567351293678314
WV,Roane County,54087,1220,3772,5234,0.233091325945739,0.720672525792893,2552,-0.487581199847153,54087,5027,1928,2973,87,54,0.383528943703998,0.591406405410782,1045,-0.207877461706783
WV,Summers County,54089,1186,3444,4847,0.24468743552713,0.710542603672375,2258,-0.465855168145245,54089,4712,1612,2968,89,54,0.342105263157895,0.629881154499151,1356,-0.287775891341256
WV,Taylor County,54091,1483,4701,6498,0.228224068944291,0.723453370267775,3218,-0.495229301323484,54091,5887,1933,3827,91,54,0.328350603023611,0.650076439612706,1894,-0.321725836589095
WV,Tucker County,54093,750,2557,3464,0.216512702078522,0.738163972286374,1807,-0.521651270207852,54093,3118,876,2160,93,54,0.280949326491341,0.692751763951251,1284,-0.41180243745991
WV,Tyler County,54095,505,2967,3621,0.139464236398785,0.819386909693455,2462,-0.67992267329467,54095,3245,880,2291,95,54,0.271186440677966,0.706009244992296,1411,-0.43482280431433
WV,Upshur County,54097,1763,6971,9180,0.192047930283224,0.759368191721133,5208,-0.567320261437908,54097,8195,2143,5878,97,54,0.26150091519219,0.717266625991458,3735,-0.455765710799268
WV,Wayne County,54099,3334,11077,15080,0.221087533156499,0.734549071618037,7743,-0.513461538461539,54099,13923,4915,8673,99,54,0.353013000071824,0.622926093514329,3758,-0.269913093442505
WV,Webster County,54101,554,2284,2955,0.187478849407783,0.772927241962775,1730,-0.585448392554992,54101,2744,939,1708,101,54,0.342201166180758,0.622448979591837,769,-0.280247813411079
WV,Wetzel County,54103,1348,4461,6191,0.217735422387336,0.720562106283315,3113,-0.502826683895978,54103,5808,2194,3449,103,54,0.377754820936639,0.59383608815427,1255,-0.216081267217631
WV,Wirt County,54105,383,1903,2410,0.158921161825726,0.789626556016597,1520,-0.630705394190871,54105,2163,673,1422,105,54,0.311141932501156,0.657420249653259,749,-0.346278317152104
WV,Wood County,54107,8327,25168,35256,0.23618674835489,0.713864306784661,16841,-0.477677558429771,54107,33600,11067,21980,107,54,0.329375,0.654166666666667,10913,-0.324791666666667
WV,Wyoming County,54109,1061,6527,7809,0.135868869253426,0.835830452042515,5466,-0.69996158278909,54109,7496,1575,5751,109,54,0.210112059765208,0.767209178228389,4176,-0.55709711846318
WI,Adams County,55001,3780,5983,10107,0.3739982190561,0.591965964183239,2203,-0.21796774512714,55001,10263,5537,4643,1,55,0.539510864269707,0.452401831823054,894,0.087109032446653
WI,Ashland County,55003,4136,3428,7926,0.52182689881403,0.432500630835226,708,0.089326267978804,55003,8342,5387,2816,3,55,0.645768400863102,0.337568928314553,2571,0.30819947254855
WI,Barron County,55005,7881,13595,22514,0.350048858488052,0.603846495513902,5714,-0.253797637025851,55005,22583,10883,11413,5,55,0.481911172120622,0.505380153212594,530,-0.023468981091972
WI,Bayfield County,55007,4953,4125,9491,0.521862817405964,0.43462227373301,828,0.087240543672953,55007,9759,6025,3597,7,55,0.617378829798135,0.368582846603136,2428,0.248795983195
WI,Brown County,55009,53358,67192,127497,0.418503964799172,0.52700847863087,13834,-0.108504513831698,55009,128514,62433,64738,9,55,0.48580699379056,0.503742782887468,2305,-0.017935789096908
WI,Buffalo County,55011,2531,4049,6921,0.365698598468429,0.585031064875018,1518,-0.219332466406589,55011,7008,3569,3352,11,55,0.509275114155251,0.478310502283105,217,0.030964611872146
WI,Burnett County,55013,2948,5412,8719,0.3381121688267,0.62071338456245,2464,-0.28260121573575,55013,8634,3981,4541,13,55,0.461084086170952,0.525943942552699,560,-0.064859856381747
WI,Calumet County,55015,9634,15345,26429,0.364523818532672,0.580612206288547,5711,-0.216088387755874,55015,26336,11477,14519,15,55,0.435791312272175,0.551298602673147,3042,-0.115507290400972
WI,Chippewa County,55017,11875,17912,31471,0.377331511550316,0.569158908201201,6037,-0.191827396650885,55017,30914,15211,15371,17,55,0.492042440318302,0.497218088891764,160,-0.005175648573462
WI,Clark County,55019,4225,8645,13548,0.311854148213758,0.638101564806613,4420,-0.326247416592855,55019,13740,6173,7394,19,55,0.449272197962154,0.538136826783115,1221,-0.088864628820961
WI,Columbia County,55021,13525,14160,29287,0.461808993751494,0.48349096868918,635,-0.021681974937686,55021,30460,17158,13014,21,55,0.563296126066973,0.427248850952068,4144,0.136047275114905
WI,Crawford County,55023,3426,3844,7678,0.446209950507945,0.50065121125293,418,-0.054441260744986,55023,7791,4622,3064,23,55,0.593248620202798,0.393274290848415,1558,0.199974329354383
WI,Dane County,55025,217506,71270,304729,0.713768627206469,0.233879939224688,146236,0.479888687981781,55025,302845,215389,83459,25,55,0.711218610180125,0.275583219138503,131930,0.435635391041622
WI,Dodge County,55027,13968,26643,42818,0.326217945723761,0.622238310990705,12675,-0.296020365266944,55027,44379,18745,25190,27,55,0.422384461118998,0.56761080691318,6445,-0.145226345794182
WI,Door County,55029,8026,8584,17398,0.461317392803771,0.493390044832739,558,-0.032072652028969,55029,17607,9338,8109,29,55,0.530357244277844,0.460555460896235,1229,0.06980178338161
WI,Douglas County,55031,11342,9657,22185,0.511246337615506,0.435294117647059,1685,0.075952219968447,55031,22862,14855,7698,31,55,0.649768174262969,0.336715947861079,7157,0.31305222640189
WI,Dunn County,55033,9025,11487,22029,0.409687230468927,0.521448999046711,2462,-0.111761768577784,55033,21899,11303,10210,33,55,0.516142289602265,0.466231334764145,1093,0.049910954838121
WI,Eau Claire County,55035,27271,23301,54080,0.504271449704142,0.430861686390533,3970,0.07340976331361,55035,54595,30618,23218,35,55,0.560820587965931,0.42527704002198,7400,0.135543547943951
WI,Florence County,55037,666,1897,2651,0.251225952470766,0.715579026782346,1231,-0.464353074311581,55037,2615,952,1643,37,55,0.364053537284895,0.6282982791587,691,-0.264244741873805
WI,Fond du Lac County,55039,17391,31044,51094,0.340372646494696,0.607586017927741,13653,-0.267213371433045,55039,53272,22356,30329,39,55,0.419657606247184,0.569323471992792,7973,-0.149665865745608
WI,Forest County,55041,1583,2787,4507,0.351231417794542,0.618371422232083,1204,-0.267140004437542,55041,4643,2421,2172,41,55,0.521430109842774,0.467800990738746,249,0.053629119104028
WI,Grant County,55043,10047,12347,24051,0.417737308220032,0.51336742754979,2300,-0.095630119329758,55043,24160,13574,10255,43,55,0.561837748344371,0.424461920529801,3319,0.13737582781457
WI,Green County,55045,9121,8693,18791,0.485391942951413,0.462615081688042,428,0.022776861263371,55045,19302,11196,7848,45,55,0.580043518806341,0.406589990674542,3348,0.1734535281318
WI,Green Lake County,55047,2700,6210,9315,0.289855072463768,0.666666666666667,3510,-0.376811594202898,55047,9657,3790,5779,47,55,0.392461426944186,0.598426012219116,1989,-0.20596458527493
WI,Iowa County,55049,6669,4809,12123,0.55011135857461,0.396683989111606,1860,0.153427369463004,55049,12515,8099,4302,49,55,0.647143427886536,0.343747502996404,3797,0.303395924890132
WI,Iron County,55051,1273,2090,3477,0.366120218579235,0.601092896174863,817,-0.234972677595628,55051,3620,1783,1788,51,55,0.492541436464088,0.493922651933702,5,-0.001381215469613
WI,Jackson County,55053,3821,4907,9202,0.415235818300369,0.533253640512932,1086,-0.118017822212563,55053,9290,5297,3900,53,55,0.570182992465016,0.419806243272336,1397,0.15037674919268
WI,Jefferson County,55055,16559,23409,42324,0.391243738777053,0.553090445137511,6850,-0.161846706360457,55055,44136,20136,23489,55,55,0.456226209896683,0.532195939822367,3353,-0.075969729925684
WI,Juneau County,55057,4100,7188,11736,0.349352419904567,0.612474437627812,3088,-0.263122017723245,55057,11781,6237,5400,57,55,0.529411764705882,0.458365164247517,837,0.071046600458365
WI,Kenosha County,55059,35770,36025,75825,0.471744147708539,0.475107154632377,255,-0.003363006923838,55059,80661,44838,34942,59,55,0.555882024770335,0.433195720360521,9896,0.122686304409814
WI,Kewaunee County,55061,3623,6616,10742,0.337274250605101,0.615900204803575,2993,-0.278625954198473,55061,11018,5151,5746,61,55,0.467507714648757,0.521510255944818,595,-0.054002541296061
WI,La Crosse County,55063,32402,26384,62785,0.516078681213666,0.42022776140798,6018,0.095850919805686,55063,63212,36632,25711,63,55,0.579510219578561,0.406742390685313,10921,0.172767828893248
WI,Lafayette County,55065,3288,3977,7602,0.432517758484609,0.523151802157327,689,-0.090634043672718,55065,7928,4534,3313,65,55,0.571897073662967,0.417885973763875,1221,0.154011099899092
WI,Langlade County,55067,3260,6436,10093,0.322996135935797,0.637669672049936,3176,-0.314673536114139,55067,10482,4569,5810,67,55,0.435890097309674,0.554283533676779,1241,-0.118393436367106
WI,Lincoln County,55069,5370,8400,14563,0.368742704113163,0.576804229897686,3030,-0.208061525784522,55069,15152,7543,7444,69,55,0.49782206969377,0.491288278775079,99,0.006533790918691
WI,Manitowoc County,55071,14563,23234,39991,0.364156935310445,0.580980720662149,8671,-0.216823785351704,55071,42488,20382,21581,71,55,0.479711918659386,0.507931651289776,1199,-0.02821973263039
WI,Marathon County,55073,26476,39010,68849,0.384551700097314,0.56660227454284,12534,-0.182050574445526,55073,69637,32330,36568,73,55,0.46426468687623,0.525123138561397,4238,-0.060858451685167
WI,Marinette County,55075,6243,12995,19979,0.312478102007107,0.650432954602332,6752,-0.337954852595225,55075,20712,9868,10609,75,55,0.476438779451526,0.512215140981074,741,-0.035776361529548
WI,Marquette County,55077,2808,4712,7813,0.359400998336106,0.603097401766287,1904,-0.24369640343018,55077,7944,4112,3758,77,55,0.517623363544814,0.47306143001007,354,0.044561933534743
WI,Menominee County,55078,1003,269,1279,0.784206411258796,0.210320562939797,734,0.573885848318999,55078,1376,1191,179,78,55,0.865552325581395,0.130087209302326,1012,0.73546511627907
WI,Milwaukee County,55079,288986,126091,434970,0.664381451594363,0.289884359840909,162895,0.374497091753454,55079,490944,328090,158430,79,55,0.668283959066615,0.322704829878764,169660,0.34557912918785
WI,Monroe County,55081,7047,11442,19554,0.360386621663087,0.585148818656029,4395,-0.224762196992943,55081,19389,9505,9637,81,55,0.49022641704059,0.497034400948992,132,-0.006807983908402
WI,Oconto County,55083,5886,13255,19924,0.295422605902429,0.665278056615137,7369,-0.369855450712708,55083,19727,8810,10691,83,55,0.446596035889897,0.541947584528818,1881,-0.095351548638921
WI,Oneida County,55085,8103,11677,20837,0.388875557901809,0.560397370062869,3574,-0.17152181216106,55085,21577,10439,10905,85,55,0.483802196783612,0.505399267738796,466,-0.021597070955184
WI,Outagamie County,55087,38087,49884,93474,0.407460898217686,0.533667115989473,11797,-0.126206217771787,55087,94237,45565,47294,87,55,0.483514967581735,0.501862325838047,1729,-0.018347358256311
WI,Ozaukee County,55089,20167,30458,53368,0.377885624344176,0.570716534252736,10291,-0.192830909908559,55089,55565,19075,35991,89,55,0.343291640421128,0.647727886259336,16916,-0.304436245838207
WI,Pepin County,55091,1345,2228,3746,0.359049652963161,0.594767752269087,883,-0.235718099305926,55091,3696,1875,1793,91,55,0.507305194805195,0.485119047619048,82,0.022186147186147
WI,Pierce County,55093,8380,11260,21089,0.397363554459671,0.533927640001897,2880,-0.136564085542226,55093,20920,10213,10383,93,55,0.488193116634799,0.49631931166348,170,-0.008126195028681
WI,Polk County,55095,7568,13864,22691,0.333524304790446,0.610991141862412,6296,-0.277466837071967,55095,22494,10054,12075,95,55,0.446963634747044,0.53680981595092,2021,-0.089846181203877
WI,Portage County,55097,18524,17310,38123,0.48590089971933,0.454056606248197,1214,0.031844293471133,55097,39186,22052,16599,97,55,0.562752003266473,0.423595161537284,5453,0.139156841729189
WI,Price County,55099,2671,4562,7560,0.353306878306878,0.603439153439153,1891,-0.250132275132275,55099,7870,3882,3879,99,55,0.493265565438374,0.492884371029225,3,0.000381194409149
WI,Racine County,55101,42506,46620,93678,0.453745810115502,0.497662204573112,4114,-0.04391639445761,55101,102937,52887,49173,101,55,0.513780273371091,0.477699952398069,3714,0.036080320973022
WI,Richland County,55103,3577,4021,7962,0.44925898015574,0.505023863350917,444,-0.055764883195177,55103,8636,4964,3575,103,55,0.574803149606299,0.413964798517832,1389,0.160838351088467
WI,Rock County,55105,39336,31483,75043,0.524179470436949,0.419532801193982,7853,0.104646669242967,55105,80462,49158,30492,105,55,0.610946782332032,0.378961497352788,18666,0.231985284979245
WI,Rusk County,55107,2171,4564,7029,0.308863280694267,0.649310001422677,2393,-0.340446720728411,55107,7171,3391,3673,107,55,0.472876865151304,0.512201924417794,282,-0.03932505926649
WI,St. Croix County,55109,17496,26123,46819,0.373694440291335,0.557957239582221,8627,-0.184262799290886,55109,46009,19874,25475,109,55,0.431958964550414,0.55369601599687,5601,-0.121737051446456
WI,Sauk County,55111,14692,14791,31238,0.470324604648185,0.473493821627505,99,-0.00316921697932,55111,31832,18718,12829,111,55,0.588024629303845,0.403022116109575,5889,0.18500251319427
WI,Sawyer County,55113,2846,4625,7767,0.366422041972448,0.595468005664993,1779,-0.229045963692545,55113,9003,4482,4436,113,55,0.497834055314895,0.492724647339776,46,0.005109407975119
WI,Shawano County,55115,6056,12742,19697,0.307457988526171,0.646900543229934,6686,-0.339442554703762,55115,20222,8990,11017,115,55,0.44456532489368,0.544802690139452,2027,-0.100237365245772
WI,Sheboygan County,55117,22636,32368,58290,0.388334191113398,0.55529250300223,9732,-0.166958311888832,55117,63272,28356,34282,117,55,0.448160323681881,0.541819446200531,5926,-0.09365912251865
WI,Taylor County,55119,2398,6589,9417,0.254645853244133,0.699692046299246,4191,-0.445046193055113,55119,9486,3761,5597,119,55,0.396479021716213,0.590027408812988,1836,-0.193548387096774
WI,Trempealeau County,55121,5645,7370,13581,0.415654222811281,0.542669906487004,1725,-0.127015683675723,55121,13456,7601,5703,121,55,0.564878121284185,0.423825802615933,1898,0.141052318668252
WI,Vernon County,55123,6351,6994,14193,0.447474106954132,0.492778130064116,643,-0.045304023109984,55123,14215,8031,5935,123,55,0.564966584593739,0.417516707703131,2096,0.147449876890609
WI,Vilas County,55125,4769,8169,13453,0.354493421541664,0.60722515424069,3400,-0.252731732699026,55125,13782,5931,7735,125,55,0.430343926861123,0.561239297634596,1804,-0.130895370773473
WI,Walworth County,55127,18706,28848,50570,0.369903104607475,0.570456792564762,10142,-0.200553687957287,55127,52115,22512,28962,127,55,0.431967763599731,0.555732514631104,6450,-0.123764751031373
WI,Washburn County,55129,3283,5404,9059,0.362402031129264,0.596533833756485,2121,-0.234131802627222,55129,9242,4435,4692,129,55,0.479874486041982,0.50768231984419,257,-0.027807833802207
WI,Washington County,55131,20854,51729,76246,0.273509430002885,0.678448705505863,30875,-0.404939275502977,55131,78558,23136,54709,131,55,0.294508516000917,0.696415387357112,31573,-0.401906871356195
WI,Waukesha County,55133,79200,142521,233273,0.33951636065897,0.610962263099459,63321,-0.271445902440488,55133,241084,77617,161567,133,55,0.321950025717177,0.670168903784573,83950,-0.348218878067396
WI,Waupaca County,55135,8303,16013,25491,0.325722804126947,0.628182495782825,7710,-0.302459691655878,55135,25801,11565,13989,135,55,0.448238440370528,0.542188287275687,2424,-0.093949846905159
WI,Waushara County,55137,3802,7669,11961,0.317866399130507,0.64116712649444,3867,-0.323300727363933,55137,12017,5330,6558,137,55,0.443538320712324,0.545726886910211,1228,-0.102188566197886
WI,Winnebago County,55139,37054,43447,85892,0.43140222605132,0.505832906440646,6393,-0.074430680389326,55139,88814,45410,42073,139,55,0.511293264575405,0.473720359402797,3337,0.037572905172608
WI,Wood County,55141,14232,21502,37712,0.377386508273229,0.570163343232923,7270,-0.192776834959694,55141,38762,18546,19685,141,55,0.47845828388628,0.507842732573139,1139,-0.029384448686858
WY,Albany County,56001,6888,7601,16420,0.419488428745432,0.462911084043849,713,-0.043422655298417,56001,16052,7445,7851,1,56,0.463805133316721,0.489097931721904,406,-0.025292798405183
WY,Big Horn County,56003,594,4067,5079,0.116952155936208,0.800748178775349,3473,-0.683796022839142,56003,5262,868,4269,3,56,0.164956290383884,0.811288483466363,3401,-0.646332193082478
WY,Campbell County,56005,1324,15778,17935,0.073822135489267,0.879732366880401,14454,-0.805910231391135,56005,17477,2163,14952,5,56,0.123762659495337,0.855524403501745,12789,-0.731761744006408
WY,Carbon County,56007,1279,4409,6200,0.206290322580645,0.711129032258065,3130,-0.504838709677419,56007,6461,2109,4152,7,56,0.326420058814425,0.64262498065315,2043,-0.316204921838725
WY,Converse County,56009,668,5520,6552,0.101953601953602,0.842490842490843,4852,-0.740537240537241,56009,6287,1089,5043,9,56,0.173214569747097,0.802131382217274,3954,-0.628916812470177
WY,Crook County,56011,271,3347,3771,0.071864226995492,0.88756298064174,3076,-0.815698753646248,56011,3657,426,3109,11,56,0.116488925348646,0.850150396499863,2683,-0.733661471151217
WY,Fremont County,56013,4200,11167,16543,0.253883817929033,0.675028713050837,6967,-0.421144895121804,56013,16817,5333,11072,13,56,0.317119581375989,0.658381399774038,5739,-0.34126181839805
WY,Goshen County,56015,924,4418,5708,0.16187806587246,0.774001401541696,3494,-0.612123335669236,56015,5758,1458,4178,15,56,0.253212921153178,0.725599166377214,2720,-0.472386245224036
WY,Hot Springs County,56017,400,1939,2535,0.157790927021696,0.764891518737673,1539,-0.607100591715976,56017,2495,523,1894,17,56,0.209619238476954,0.759118236472946,1371,-0.549498997995992
WY,Johnson County,56019,638,3477,4349,0.146700390894458,0.799494136583123,2839,-0.652793745688664,56019,4217,749,3362,19,56,0.177614417832582,0.797249229309936,2613,-0.619634811477354
WY,Laramie County,56021,11572,24844,39945,0.289698335210915,0.621955188384028,13272,-0.332256853173113,56021,38057,13807,23247,21,56,0.362797908400557,0.610846887563392,9440,-0.248048979162835
WY,Lincoln County,56023,1105,6779,8398,0.131578947368421,0.807216003810431,5674,-0.67563705644201,56023,8573,1287,7144,23,56,0.150122477545783,0.83331389245305,5857,-0.683191414907267
WY,Natrona County,56025,6573,23523,32493,0.202289723940541,0.723940541039609,16950,-0.521650817099067,56025,32057,8960,22129,25,56,0.279502136818792,0.690301650185607,13169,-0.410799513366815
WY,Niobrara County,56027,115,1116,1297,0.088666152659985,0.860447185813416,1001,-0.771781033153431,56027,1268,200,1022,27,56,0.157728706624606,0.805993690851735,822,-0.648264984227129
WY,Park County,56029,2535,11115,14634,0.173226732267323,0.759532595325953,8580,-0.586305863058631,56029,14492,2927,11234,29,56,0.201973502622136,0.775186309688104,8307,-0.573212807065967
WY,Platte County,56031,719,3437,4460,0.161210762331839,0.770627802690583,2718,-0.609417040358744,56031,4500,1223,3136,31,56,0.271777777777778,0.696888888888889,1913,-0.425111111111111
WY,Sheridan County,56033,2926,10266,14187,0.206245154014238,0.723620215690421,7340,-0.517375061676182,56033,14225,3618,10267,33,56,0.254340949033392,0.721757469244288,6649,-0.467416520210896
WY,Sublette County,56035,644,3409,4297,0.149872003723528,0.793344193623458,2765,-0.64347218989993,56035,4337,767,3472,35,56,0.176850357389901,0.800553377910998,2705,-0.623703020521097
WY,Sweetwater County,56037,3233,12153,16661,0.194045975631715,0.729428005521877,8920,-0.535382029890163,56037,16750,4773,11427,37,56,0.284955223880597,0.682208955223881,6654,-0.397253731343284
WY,Teton County,56039,7313,3920,12176,0.600607752956636,0.321944809461235,3393,0.278662943495401,56039,11356,6211,4858,39,56,0.546935540683339,0.427791475871786,1353,0.119144064811553
WY,Uinta County,56041,1202,6154,8053,0.149261144914939,0.764187259406432,4952,-0.614926114491494,56041,8453,1628,6613,41,56,0.192594345202887,0.782325801490595,4985,-0.589731456287709
WY,Washakie County,56043,532,2911,3715,0.143203230148048,0.783580080753701,2379,-0.640376850605653,56043,3911,794,3013,43,56,0.203017131168499,0.770391204295577,2219,-0.567374073127077
WY,Weston County,56045,294,2898,3334,0.088182363527295,0.869226154769046,2604,-0.781043791241752,56045,3323,422,2821,45,56,0.126993680409269,0.848931688233524,2399,-0.721938007824255
